{
    "Keys": [
        {
            "ETag": "\"d41d8cd98f00b204e9800998ecf8427e\"", 
            "Key": "2002/05/", 
            "Size": 0
        }
    ], 
    "CommonPrefixes": [
        "2002/05/01/", 
        "2002/05/02/", 
        "2002/05/03/", 
        "2002/05/04/", 
        "2002/05/05/", 
        "2002/05/06/", 
        "2002/05/07/", 
        "2002/05/08/", 
        "2002/05/09/", 
        "2002/05/10/", 
        "2002/05/11/", 
        "2002/05/12/", 
        "2002/05/13/", 
        "2002/05/14/", 
        "2002/05/15/", 
        "2002/05/16/", 
        "2002/05/17/", 
        "2002/05/18/", 
        "2002/05/19/", 
        "2002/05/20/", 
        "2002/05/21/", 
        "2002/05/22/", 
        "2002/05/23/", 
        "2002/05/24/", 
        "2002/05/25/", 
        "2002/05/26/", 
        "2002/05/27/", 
        "2002/05/28/", 
        "2002/05/29/", 
        "2002/05/30/", 
        "2002/05/31/"
    ]
}
