{
    "Keys": [
        {
            "ETag": "\"d41d8cd98f00b204e9800998ecf8427e\"", 
            "Key": "1994/11/", 
            "Size": 0
        }
    ], 
    "CommonPrefixes": [
        "1994/11/01/", 
        "1994/11/02/", 
        "1994/11/03/", 
        "1994/11/04/", 
        "1994/11/05/", 
        "1994/11/06/", 
        "1994/11/07/", 
        "1994/11/08/", 
        "1994/11/09/", 
        "1994/11/10/", 
        "1994/11/11/", 
        "1994/11/12/", 
        "1994/11/13/", 
        "1994/11/14/", 
        "1994/11/15/", 
        "1994/11/16/", 
        "1994/11/17/", 
        "1994/11/18/", 
        "1994/11/19/", 
        "1994/11/20/", 
        "1994/11/21/", 
        "1994/11/22/", 
        "1994/11/23/", 
        "1994/11/24/", 
        "1994/11/25/", 
        "1994/11/26/", 
        "1994/11/27/", 
        "1994/11/28/", 
        "1994/11/29/", 
        "1994/11/30/"
    ]
}
