{
    "Keys": [
        {
            "ETag": "\"d41d8cd98f00b204e9800998ecf8427e\"", 
            "Key": "1998/03/", 
            "Size": 0
        }
    ], 
    "CommonPrefixes": [
        "1998/03/01/", 
        "1998/03/02/", 
        "1998/03/03/", 
        "1998/03/04/", 
        "1998/03/05/", 
        "1998/03/06/", 
        "1998/03/07/", 
        "1998/03/08/", 
        "1998/03/09/", 
        "1998/03/10/", 
        "1998/03/11/", 
        "1998/03/12/", 
        "1998/03/13/", 
        "1998/03/14/", 
        "1998/03/15/", 
        "1998/03/16/", 
        "1998/03/17/", 
        "1998/03/18/", 
        "1998/03/19/", 
        "1998/03/20/", 
        "1998/03/21/", 
        "1998/03/22/", 
        "1998/03/23/", 
        "1998/03/24/", 
        "1998/03/25/", 
        "1998/03/26/", 
        "1998/03/27/", 
        "1998/03/28/", 
        "1998/03/29/", 
        "1998/03/30/", 
        "1998/03/31/"
    ]
}
