{
    "Keys": [
        {
            "ETag": "\"d41d8cd98f00b204e9800998ecf8427e\"", 
            "Key": "2000/04/", 
            "Size": 0
        }
    ], 
    "CommonPrefixes": [
        "2000/04/01/", 
        "2000/04/02/", 
        "2000/04/03/", 
        "2000/04/04/", 
        "2000/04/05/", 
        "2000/04/06/", 
        "2000/04/07/", 
        "2000/04/08/", 
        "2000/04/09/", 
        "2000/04/10/", 
        "2000/04/11/", 
        "2000/04/12/", 
        "2000/04/13/", 
        "2000/04/14/", 
        "2000/04/15/", 
        "2000/04/16/", 
        "2000/04/17/", 
        "2000/04/18/", 
        "2000/04/19/", 
        "2000/04/20/", 
        "2000/04/21/", 
        "2000/04/22/", 
        "2000/04/23/", 
        "2000/04/24/", 
        "2000/04/25/", 
        "2000/04/26/", 
        "2000/04/27/", 
        "2000/04/28/", 
        "2000/04/29/", 
        "2000/04/30/"
    ]
}
