{
    "Keys": [
        {
            "ETag": "\"d41d8cd98f00b204e9800998ecf8427e\"", 
            "Key": "2007/08/", 
            "Size": 0
        }
    ], 
    "CommonPrefixes": [
        "2007/08/01/", 
        "2007/08/02/", 
        "2007/08/03/", 
        "2007/08/04/", 
        "2007/08/05/", 
        "2007/08/06/", 
        "2007/08/07/", 
        "2007/08/08/", 
        "2007/08/09/", 
        "2007/08/10/", 
        "2007/08/11/", 
        "2007/08/12/", 
        "2007/08/13/", 
        "2007/08/14/", 
        "2007/08/15/", 
        "2007/08/16/", 
        "2007/08/17/", 
        "2007/08/18/", 
        "2007/08/19/", 
        "2007/08/20/", 
        "2007/08/21/", 
        "2007/08/22/", 
        "2007/08/23/", 
        "2007/08/24/", 
        "2007/08/25/", 
        "2007/08/26/", 
        "2007/08/27/", 
        "2007/08/28/", 
        "2007/08/29/", 
        "2007/08/30/", 
        "2007/08/31/"
    ]
}
