{
    "Keys": [
        {
            "ETag": "\"d41d8cd98f00b204e9800998ecf8427e\"", 
            "Key": "2003/03/", 
            "Size": 0
        }
    ], 
    "CommonPrefixes": [
        "2003/03/01/", 
        "2003/03/02/", 
        "2003/03/03/", 
        "2003/03/04/", 
        "2003/03/05/", 
        "2003/03/06/", 
        "2003/03/07/", 
        "2003/03/08/", 
        "2003/03/09/", 
        "2003/03/10/", 
        "2003/03/11/", 
        "2003/03/12/", 
        "2003/03/13/", 
        "2003/03/14/", 
        "2003/03/15/", 
        "2003/03/16/", 
        "2003/03/17/", 
        "2003/03/18/", 
        "2003/03/19/", 
        "2003/03/20/", 
        "2003/03/21/", 
        "2003/03/22/", 
        "2003/03/23/", 
        "2003/03/24/", 
        "2003/03/25/", 
        "2003/03/26/", 
        "2003/03/27/", 
        "2003/03/28/", 
        "2003/03/29/", 
        "2003/03/30/", 
        "2003/03/31/"
    ]
}
