{
    "Keys": [
        {
            "ETag": "\"d41d8cd98f00b204e9800998ecf8427e\"", 
            "Key": "1991/11/", 
            "Size": 0
        }
    ], 
    "CommonPrefixes": [
        "1991/11/01/", 
        "1991/11/02/", 
        "1991/11/03/", 
        "1991/11/05/", 
        "1991/11/06/", 
        "1991/11/07/", 
        "1991/11/08/", 
        "1991/11/12/", 
        "1991/11/18/", 
        "1991/11/19/", 
        "1991/11/20/", 
        "1991/11/21/", 
        "1991/11/22/", 
        "1991/11/23/", 
        "1991/11/24/", 
        "1991/11/29/", 
        "1991/11/30/"
    ]
}
