{
    "Keys": [
        {
            "ETag": "\"d41d8cd98f00b204e9800998ecf8427e\"", 
            "Key": "1993/03/", 
            "Size": 0
        }
    ], 
    "CommonPrefixes": [
        "1993/03/01/", 
        "1993/03/02/", 
        "1993/03/03/", 
        "1993/03/04/", 
        "1993/03/05/", 
        "1993/03/06/", 
        "1993/03/07/", 
        "1993/03/08/", 
        "1993/03/09/", 
        "1993/03/10/", 
        "1993/03/11/", 
        "1993/03/12/", 
        "1993/03/13/", 
        "1993/03/14/", 
        "1993/03/15/", 
        "1993/03/16/", 
        "1993/03/17/", 
        "1993/03/18/", 
        "1993/03/19/", 
        "1993/03/20/", 
        "1993/03/21/", 
        "1993/03/22/", 
        "1993/03/23/", 
        "1993/03/24/", 
        "1993/03/25/", 
        "1993/03/26/", 
        "1993/03/27/", 
        "1993/03/28/", 
        "1993/03/29/", 
        "1993/03/30/", 
        "1993/03/31/"
    ]
}
