{
    "Keys": null, 
    "CommonPrefixes": [
        "2015/01/01/", 
        "2015/01/02/", 
        "2015/01/03/", 
        "2015/01/04/", 
        "2015/01/05/", 
        "2015/01/06/", 
        "2015/01/07/", 
        "2015/01/08/", 
        "2015/01/09/", 
        "2015/01/10/", 
        "2015/01/11/", 
        "2015/01/12/", 
        "2015/01/13/", 
        "2015/01/14/", 
        "2015/01/15/", 
        "2015/01/16/", 
        "2015/01/17/", 
        "2015/01/18/", 
        "2015/01/19/", 
        "2015/01/20/", 
        "2015/01/21/", 
        "2015/01/22/", 
        "2015/01/23/", 
        "2015/01/24/", 
        "2015/01/25/", 
        "2015/01/26/", 
        "2015/01/27/", 
        "2015/01/28/", 
        "2015/01/29/", 
        "2015/01/30/", 
        "2015/01/31/"
    ]
}
