{
    "Keys": null, 
    "CommonPrefixes": [
        "2016/08/01/", 
        "2016/08/02/", 
        "2016/08/03/", 
        "2016/08/04/", 
        "2016/08/05/", 
        "2016/08/06/", 
        "2016/08/07/", 
        "2016/08/08/", 
        "2016/08/09/", 
        "2016/08/10/", 
        "2016/08/11/", 
        "2016/08/12/", 
        "2016/08/13/", 
        "2016/08/14/", 
        "2016/08/15/", 
        "2016/08/16/", 
        "2016/08/17/", 
        "2016/08/18/", 
        "2016/08/19/", 
        "2016/08/20/", 
        "2016/08/21/", 
        "2016/08/22/", 
        "2016/08/23/", 
        "2016/08/24/", 
        "2016/08/25/", 
        "2016/08/26/", 
        "2016/08/27/", 
        "2016/08/28/", 
        "2016/08/29/", 
        "2016/08/30/", 
        "2016/08/31/"
    ]
}
