{
    "Keys": [
        {
            "ETag": "\"d41d8cd98f00b204e9800998ecf8427e\"", 
            "Key": "1998/06/", 
            "Size": 0
        }
    ], 
    "CommonPrefixes": [
        "1998/06/01/", 
        "1998/06/02/", 
        "1998/06/03/", 
        "1998/06/04/", 
        "1998/06/05/", 
        "1998/06/06/", 
        "1998/06/07/", 
        "1998/06/08/", 
        "1998/06/09/", 
        "1998/06/10/", 
        "1998/06/11/", 
        "1998/06/12/", 
        "1998/06/13/", 
        "1998/06/14/", 
        "1998/06/15/", 
        "1998/06/16/", 
        "1998/06/17/", 
        "1998/06/18/", 
        "1998/06/19/", 
        "1998/06/20/", 
        "1998/06/21/", 
        "1998/06/22/", 
        "1998/06/23/", 
        "1998/06/24/", 
        "1998/06/25/", 
        "1998/06/26/", 
        "1998/06/27/", 
        "1998/06/28/", 
        "1998/06/29/", 
        "1998/06/30/"
    ]
}
