{
    "Keys": [
        {
            "ETag": "\"d41d8cd98f00b204e9800998ecf8427e\"", 
            "Key": "1996/09/", 
            "Size": 0
        }
    ], 
    "CommonPrefixes": [
        "1996/09/01/", 
        "1996/09/02/", 
        "1996/09/03/", 
        "1996/09/04/", 
        "1996/09/05/", 
        "1996/09/06/", 
        "1996/09/07/", 
        "1996/09/08/", 
        "1996/09/09/", 
        "1996/09/10/", 
        "1996/09/11/", 
        "1996/09/12/", 
        "1996/09/13/", 
        "1996/09/14/", 
        "1996/09/15/", 
        "1996/09/16/", 
        "1996/09/17/", 
        "1996/09/18/", 
        "1996/09/19/", 
        "1996/09/20/", 
        "1996/09/21/", 
        "1996/09/22/", 
        "1996/09/23/", 
        "1996/09/24/", 
        "1996/09/25/", 
        "1996/09/26/", 
        "1996/09/27/", 
        "1996/09/28/", 
        "1996/09/29/", 
        "1996/09/30/"
    ]
}
