{
    "Keys": [
        {
            "ETag": "\"d41d8cd98f00b204e9800998ecf8427e\"", 
            "Key": "1999/02/", 
            "Size": 0
        }
    ], 
    "CommonPrefixes": [
        "1999/02/01/", 
        "1999/02/02/", 
        "1999/02/03/", 
        "1999/02/04/", 
        "1999/02/05/", 
        "1999/02/06/", 
        "1999/02/07/", 
        "1999/02/08/", 
        "1999/02/09/", 
        "1999/02/10/", 
        "1999/02/11/", 
        "1999/02/12/", 
        "1999/02/13/", 
        "1999/02/14/", 
        "1999/02/15/", 
        "1999/02/16/", 
        "1999/02/17/", 
        "1999/02/18/", 
        "1999/02/19/", 
        "1999/02/20/", 
        "1999/02/21/", 
        "1999/02/22/", 
        "1999/02/23/", 
        "1999/02/24/", 
        "1999/02/25/", 
        "1999/02/26/", 
        "1999/02/27/", 
        "1999/02/28/"
    ]
}
