{
    "Keys": [
        {
            "ETag": "\"d41d8cd98f00b204e9800998ecf8427e\"", 
            "Key": "2008/08/", 
            "Size": 0
        }
    ], 
    "CommonPrefixes": [
        "2008/08/01/", 
        "2008/08/02/", 
        "2008/08/03/", 
        "2008/08/04/", 
        "2008/08/05/", 
        "2008/08/06/", 
        "2008/08/07/", 
        "2008/08/08/", 
        "2008/08/09/", 
        "2008/08/10/", 
        "2008/08/11/", 
        "2008/08/12/", 
        "2008/08/13/", 
        "2008/08/14/", 
        "2008/08/15/", 
        "2008/08/16/", 
        "2008/08/17/", 
        "2008/08/18/", 
        "2008/08/19/", 
        "2008/08/20/", 
        "2008/08/21/", 
        "2008/08/22/", 
        "2008/08/23/", 
        "2008/08/24/", 
        "2008/08/25/", 
        "2008/08/26/", 
        "2008/08/27/", 
        "2008/08/28/", 
        "2008/08/29/", 
        "2008/08/30/", 
        "2008/08/31/"
    ]
}
