{
    "Keys": [
        {
            "ETag": "\"d41d8cd98f00b204e9800998ecf8427e\"", 
            "Key": "1999/01/", 
            "Size": 0
        }
    ], 
    "CommonPrefixes": [
        "1999/01/01/", 
        "1999/01/02/", 
        "1999/01/03/", 
        "1999/01/04/", 
        "1999/01/05/", 
        "1999/01/06/", 
        "1999/01/07/", 
        "1999/01/08/", 
        "1999/01/09/", 
        "1999/01/10/", 
        "1999/01/11/", 
        "1999/01/12/", 
        "1999/01/13/", 
        "1999/01/14/", 
        "1999/01/15/", 
        "1999/01/16/", 
        "1999/01/17/", 
        "1999/01/18/", 
        "1999/01/19/", 
        "1999/01/20/", 
        "1999/01/21/", 
        "1999/01/22/", 
        "1999/01/23/", 
        "1999/01/24/", 
        "1999/01/25/", 
        "1999/01/26/", 
        "1999/01/27/", 
        "1999/01/28/", 
        "1999/01/29/", 
        "1999/01/30/", 
        "1999/01/31/"
    ]
}
