{
    "Keys": [
        {
            "ETag": "\"d41d8cd98f00b204e9800998ecf8427e\"", 
            "Key": "2002/12/", 
            "Size": 0
        }
    ], 
    "CommonPrefixes": [
        "2002/12/01/", 
        "2002/12/02/", 
        "2002/12/03/", 
        "2002/12/04/", 
        "2002/12/05/", 
        "2002/12/06/", 
        "2002/12/07/", 
        "2002/12/08/", 
        "2002/12/09/", 
        "2002/12/10/", 
        "2002/12/11/", 
        "2002/12/12/", 
        "2002/12/13/", 
        "2002/12/14/", 
        "2002/12/15/", 
        "2002/12/16/", 
        "2002/12/17/", 
        "2002/12/18/", 
        "2002/12/19/", 
        "2002/12/20/", 
        "2002/12/21/", 
        "2002/12/22/", 
        "2002/12/23/", 
        "2002/12/24/", 
        "2002/12/25/", 
        "2002/12/26/", 
        "2002/12/27/", 
        "2002/12/28/", 
        "2002/12/29/", 
        "2002/12/30/", 
        "2002/12/31/"
    ]
}
