{
    "Keys": [
        {
            "ETag": "\"d41d8cd98f00b204e9800998ecf8427e\"", 
            "Key": "1995/04/", 
            "Size": 0
        }
    ], 
    "CommonPrefixes": [
        "1995/04/01/", 
        "1995/04/02/", 
        "1995/04/03/", 
        "1995/04/04/", 
        "1995/04/05/", 
        "1995/04/06/", 
        "1995/04/07/", 
        "1995/04/08/", 
        "1995/04/09/", 
        "1995/04/10/", 
        "1995/04/11/", 
        "1995/04/12/", 
        "1995/04/13/", 
        "1995/04/14/", 
        "1995/04/15/", 
        "1995/04/16/", 
        "1995/04/17/", 
        "1995/04/18/", 
        "1995/04/19/", 
        "1995/04/20/", 
        "1995/04/21/", 
        "1995/04/22/", 
        "1995/04/23/", 
        "1995/04/24/", 
        "1995/04/25/", 
        "1995/04/26/", 
        "1995/04/27/", 
        "1995/04/28/", 
        "1995/04/29/", 
        "1995/04/30/"
    ]
}
