{
    "Keys": null, 
    "CommonPrefixes": [
        "2011/12/01/", 
        "2011/12/02/", 
        "2011/12/03/", 
        "2011/12/04/", 
        "2011/12/05/", 
        "2011/12/06/", 
        "2011/12/07/", 
        "2011/12/08/", 
        "2011/12/09/", 
        "2011/12/10/", 
        "2011/12/11/", 
        "2011/12/12/", 
        "2011/12/13/", 
        "2011/12/14/", 
        "2011/12/15/", 
        "2011/12/16/", 
        "2011/12/17/", 
        "2011/12/18/", 
        "2011/12/19/", 
        "2011/12/20/", 
        "2011/12/21/", 
        "2011/12/22/", 
        "2011/12/23/", 
        "2011/12/24/", 
        "2011/12/25/", 
        "2011/12/26/", 
        "2011/12/27/", 
        "2011/12/28/", 
        "2011/12/29/", 
        "2011/12/30/", 
        "2011/12/31/"
    ]
}
