{
    "Keys": [
        {
            "ETag": "\"d41d8cd98f00b204e9800998ecf8427e\"", 
            "Key": "2003/09/", 
            "Size": 0
        }
    ], 
    "CommonPrefixes": [
        "2003/09/01/", 
        "2003/09/02/", 
        "2003/09/03/", 
        "2003/09/04/", 
        "2003/09/05/", 
        "2003/09/06/", 
        "2003/09/07/", 
        "2003/09/08/", 
        "2003/09/09/", 
        "2003/09/10/", 
        "2003/09/11/", 
        "2003/09/12/", 
        "2003/09/13/", 
        "2003/09/14/", 
        "2003/09/15/", 
        "2003/09/16/", 
        "2003/09/17/", 
        "2003/09/18/", 
        "2003/09/19/", 
        "2003/09/20/", 
        "2003/09/21/", 
        "2003/09/22/", 
        "2003/09/23/", 
        "2003/09/24/", 
        "2003/09/25/", 
        "2003/09/26/", 
        "2003/09/27/", 
        "2003/09/28/", 
        "2003/09/29/", 
        "2003/09/30/"
    ]
}
