{
    "Keys": null, 
    "CommonPrefixes": [
        "2016/06/01/", 
        "2016/06/02/", 
        "2016/06/03/", 
        "2016/06/04/", 
        "2016/06/05/", 
        "2016/06/06/", 
        "2016/06/07/", 
        "2016/06/08/", 
        "2016/06/09/", 
        "2016/06/10/", 
        "2016/06/11/", 
        "2016/06/12/", 
        "2016/06/13/", 
        "2016/06/14/", 
        "2016/06/15/", 
        "2016/06/16/", 
        "2016/06/17/", 
        "2016/06/18/", 
        "2016/06/19/", 
        "2016/06/20/", 
        "2016/06/21/", 
        "2016/06/22/", 
        "2016/06/23/", 
        "2016/06/24/", 
        "2016/06/25/", 
        "2016/06/26/", 
        "2016/06/27/", 
        "2016/06/28/", 
        "2016/06/29/", 
        "2016/06/30/"
    ]
}
