{
    "Keys": [
        {
            "ETag": "\"d41d8cd98f00b204e9800998ecf8427e\"", 
            "Key": "2004/12/", 
            "Size": 0
        }
    ], 
    "CommonPrefixes": [
        "2004/12/01/", 
        "2004/12/02/", 
        "2004/12/03/", 
        "2004/12/04/", 
        "2004/12/05/", 
        "2004/12/06/", 
        "2004/12/07/", 
        "2004/12/08/", 
        "2004/12/09/", 
        "2004/12/10/", 
        "2004/12/11/", 
        "2004/12/12/", 
        "2004/12/13/", 
        "2004/12/14/", 
        "2004/12/15/", 
        "2004/12/16/", 
        "2004/12/17/", 
        "2004/12/18/", 
        "2004/12/19/", 
        "2004/12/20/", 
        "2004/12/21/", 
        "2004/12/22/", 
        "2004/12/23/", 
        "2004/12/24/", 
        "2004/12/25/", 
        "2004/12/26/", 
        "2004/12/27/", 
        "2004/12/28/", 
        "2004/12/29/", 
        "2004/12/30/", 
        "2004/12/31/"
    ]
}
