{
    "Keys": [
        {
            "ETag": "\"d41d8cd98f00b204e9800998ecf8427e\"", 
            "Key": "1994/06/", 
            "Size": 0
        }
    ], 
    "CommonPrefixes": [
        "1994/06/01/", 
        "1994/06/02/", 
        "1994/06/03/", 
        "1994/06/04/", 
        "1994/06/05/", 
        "1994/06/06/", 
        "1994/06/07/", 
        "1994/06/08/", 
        "1994/06/09/", 
        "1994/06/10/", 
        "1994/06/11/", 
        "1994/06/12/", 
        "1994/06/13/", 
        "1994/06/14/", 
        "1994/06/15/", 
        "1994/06/16/", 
        "1994/06/17/", 
        "1994/06/18/", 
        "1994/06/19/", 
        "1994/06/20/", 
        "1994/06/21/", 
        "1994/06/22/", 
        "1994/06/23/", 
        "1994/06/24/", 
        "1994/06/25/", 
        "1994/06/26/", 
        "1994/06/27/", 
        "1994/06/28/", 
        "1994/06/29/", 
        "1994/06/30/"
    ]
}
