{
    "Keys": [
        {
            "ETag": "\"d41d8cd98f00b204e9800998ecf8427e\"", 
            "Key": "1994/12/", 
            "Size": 0
        }
    ], 
    "CommonPrefixes": [
        "1994/12/01/", 
        "1994/12/02/", 
        "1994/12/03/", 
        "1994/12/04/", 
        "1994/12/05/", 
        "1994/12/06/", 
        "1994/12/07/", 
        "1994/12/08/", 
        "1994/12/09/", 
        "1994/12/10/", 
        "1994/12/11/", 
        "1994/12/12/", 
        "1994/12/13/", 
        "1994/12/14/", 
        "1994/12/15/", 
        "1994/12/16/", 
        "1994/12/17/", 
        "1994/12/18/", 
        "1994/12/19/", 
        "1994/12/20/", 
        "1994/12/21/", 
        "1994/12/22/", 
        "1994/12/23/", 
        "1994/12/24/", 
        "1994/12/25/", 
        "1994/12/26/", 
        "1994/12/27/", 
        "1994/12/28/", 
        "1994/12/29/", 
        "1994/12/30/", 
        "1994/12/31/"
    ]
}
