{
    "Keys": [
        {
            "ETag": "\"d41d8cd98f00b204e9800998ecf8427e\"", 
            "Key": "1994/02/", 
            "Size": 0
        }
    ], 
    "CommonPrefixes": [
        "1994/02/01/", 
        "1994/02/02/", 
        "1994/02/03/", 
        "1994/02/04/", 
        "1994/02/05/", 
        "1994/02/06/", 
        "1994/02/07/", 
        "1994/02/08/", 
        "1994/02/09/", 
        "1994/02/10/", 
        "1994/02/11/", 
        "1994/02/12/", 
        "1994/02/13/", 
        "1994/02/14/", 
        "1994/02/15/", 
        "1994/02/16/", 
        "1994/02/17/", 
        "1994/02/18/", 
        "1994/02/19/", 
        "1994/02/20/", 
        "1994/02/21/", 
        "1994/02/22/", 
        "1994/02/23/", 
        "1994/02/24/", 
        "1994/02/25/", 
        "1994/02/26/", 
        "1994/02/27/", 
        "1994/02/28/"
    ]
}
