{
    "Keys": [
        {
            "ETag": "\"d41d8cd98f00b204e9800998ecf8427e\"", 
            "Key": "2000/01/", 
            "Size": 0
        }
    ], 
    "CommonPrefixes": [
        "2000/01/01/", 
        "2000/01/02/", 
        "2000/01/03/", 
        "2000/01/04/", 
        "2000/01/05/", 
        "2000/01/06/", 
        "2000/01/07/", 
        "2000/01/08/", 
        "2000/01/09/", 
        "2000/01/10/", 
        "2000/01/11/", 
        "2000/01/12/", 
        "2000/01/13/", 
        "2000/01/14/", 
        "2000/01/15/", 
        "2000/01/16/", 
        "2000/01/17/", 
        "2000/01/18/", 
        "2000/01/19/", 
        "2000/01/20/", 
        "2000/01/21/", 
        "2000/01/22/", 
        "2000/01/23/", 
        "2000/01/24/", 
        "2000/01/25/", 
        "2000/01/26/", 
        "2000/01/27/", 
        "2000/01/28/", 
        "2000/01/29/", 
        "2000/01/30/", 
        "2000/01/31/"
    ]
}
