{
    "Keys": [
        {
            "ETag": "\"d41d8cd98f00b204e9800998ecf8427e\"", 
            "Key": "1993/05/", 
            "Size": 0
        }
    ], 
    "CommonPrefixes": [
        "1993/05/01/", 
        "1993/05/02/", 
        "1993/05/03/", 
        "1993/05/04/", 
        "1993/05/05/", 
        "1993/05/06/", 
        "1993/05/07/", 
        "1993/05/08/", 
        "1993/05/09/", 
        "1993/05/10/", 
        "1993/05/11/", 
        "1993/05/12/", 
        "1993/05/13/", 
        "1993/05/14/", 
        "1993/05/15/", 
        "1993/05/16/", 
        "1993/05/17/", 
        "1993/05/18/", 
        "1993/05/19/", 
        "1993/05/20/", 
        "1993/05/21/", 
        "1993/05/22/", 
        "1993/05/23/", 
        "1993/05/24/", 
        "1993/05/25/", 
        "1993/05/26/", 
        "1993/05/27/", 
        "1993/05/28/", 
        "1993/05/29/", 
        "1993/05/30/", 
        "1993/05/31/"
    ]
}
