{
    "Keys": [
        {
            "ETag": "\"d41d8cd98f00b204e9800998ecf8427e\"", 
            "Key": "1997/03/", 
            "Size": 0
        }
    ], 
    "CommonPrefixes": [
        "1997/03/01/", 
        "1997/03/02/", 
        "1997/03/03/", 
        "1997/03/04/", 
        "1997/03/05/", 
        "1997/03/06/", 
        "1997/03/07/", 
        "1997/03/08/", 
        "1997/03/09/", 
        "1997/03/10/", 
        "1997/03/11/", 
        "1997/03/12/", 
        "1997/03/13/", 
        "1997/03/14/", 
        "1997/03/15/", 
        "1997/03/16/", 
        "1997/03/17/", 
        "1997/03/18/", 
        "1997/03/19/", 
        "1997/03/20/", 
        "1997/03/21/", 
        "1997/03/22/", 
        "1997/03/23/", 
        "1997/03/24/", 
        "1997/03/25/", 
        "1997/03/26/", 
        "1997/03/27/", 
        "1997/03/28/", 
        "1997/03/29/", 
        "1997/03/30/", 
        "1997/03/31/"
    ]
}
