{
    "Keys": [
        {
            "ETag": "\"d41d8cd98f00b204e9800998ecf8427e\"", 
            "Key": "1998/05/", 
            "Size": 0
        }
    ], 
    "CommonPrefixes": [
        "1998/05/01/", 
        "1998/05/02/", 
        "1998/05/03/", 
        "1998/05/04/", 
        "1998/05/05/", 
        "1998/05/06/", 
        "1998/05/07/", 
        "1998/05/08/", 
        "1998/05/09/", 
        "1998/05/10/", 
        "1998/05/11/", 
        "1998/05/12/", 
        "1998/05/13/", 
        "1998/05/14/", 
        "1998/05/15/", 
        "1998/05/16/", 
        "1998/05/17/", 
        "1998/05/18/", 
        "1998/05/19/", 
        "1998/05/20/", 
        "1998/05/21/", 
        "1998/05/22/", 
        "1998/05/23/", 
        "1998/05/24/", 
        "1998/05/25/", 
        "1998/05/26/", 
        "1998/05/27/", 
        "1998/05/28/", 
        "1998/05/29/", 
        "1998/05/30/", 
        "1998/05/31/"
    ]
}
