{
    "Keys": [
        {
            "ETag": "\"d41d8cd98f00b204e9800998ecf8427e\"", 
            "Key": "1996/07/", 
            "Size": 0
        }
    ], 
    "CommonPrefixes": [
        "1996/07/01/", 
        "1996/07/02/", 
        "1996/07/03/", 
        "1996/07/04/", 
        "1996/07/05/", 
        "1996/07/06/", 
        "1996/07/07/", 
        "1996/07/08/", 
        "1996/07/09/", 
        "1996/07/10/", 
        "1996/07/11/", 
        "1996/07/12/", 
        "1996/07/13/", 
        "1996/07/14/", 
        "1996/07/15/", 
        "1996/07/16/", 
        "1996/07/17/", 
        "1996/07/18/", 
        "1996/07/19/", 
        "1996/07/20/", 
        "1996/07/21/", 
        "1996/07/22/", 
        "1996/07/23/", 
        "1996/07/24/", 
        "1996/07/25/", 
        "1996/07/26/", 
        "1996/07/27/", 
        "1996/07/28/", 
        "1996/07/29/", 
        "1996/07/30/", 
        "1996/07/31/"
    ]
}
