{
    "Keys": [
        {
            "ETag": "\"d41d8cd98f00b204e9800998ecf8427e\"", 
            "Key": "1996/12/", 
            "Size": 0
        }
    ], 
    "CommonPrefixes": [
        "1996/12/01/", 
        "1996/12/02/", 
        "1996/12/03/", 
        "1996/12/04/", 
        "1996/12/05/", 
        "1996/12/06/", 
        "1996/12/07/", 
        "1996/12/08/", 
        "1996/12/09/", 
        "1996/12/10/", 
        "1996/12/11/", 
        "1996/12/12/", 
        "1996/12/13/", 
        "1996/12/14/", 
        "1996/12/15/", 
        "1996/12/16/", 
        "1996/12/17/", 
        "1996/12/18/", 
        "1996/12/19/", 
        "1996/12/20/", 
        "1996/12/21/", 
        "1996/12/22/", 
        "1996/12/23/", 
        "1996/12/24/", 
        "1996/12/25/", 
        "1996/12/26/", 
        "1996/12/27/", 
        "1996/12/28/", 
        "1996/12/29/", 
        "1996/12/30/", 
        "1996/12/31/"
    ]
}
