{
    "Keys": [
        {
            "ETag": "\"d41d8cd98f00b204e9800998ecf8427e\"", 
            "Key": "2001/12/", 
            "Size": 0
        }
    ], 
    "CommonPrefixes": [
        "2001/12/01/", 
        "2001/12/02/", 
        "2001/12/03/", 
        "2001/12/04/", 
        "2001/12/05/", 
        "2001/12/06/", 
        "2001/12/07/", 
        "2001/12/08/", 
        "2001/12/09/", 
        "2001/12/10/", 
        "2001/12/11/", 
        "2001/12/12/", 
        "2001/12/13/", 
        "2001/12/14/", 
        "2001/12/15/", 
        "2001/12/16/", 
        "2001/12/17/", 
        "2001/12/18/", 
        "2001/12/19/", 
        "2001/12/20/", 
        "2001/12/21/", 
        "2001/12/22/", 
        "2001/12/23/", 
        "2001/12/24/", 
        "2001/12/25/", 
        "2001/12/26/", 
        "2001/12/27/", 
        "2001/12/28/", 
        "2001/12/29/", 
        "2001/12/30/", 
        "2001/12/31/"
    ]
}
