{
    "Keys": [
        {
            "ETag": "\"d41d8cd98f00b204e9800998ecf8427e\"", 
            "Key": "1993/11/", 
            "Size": 0
        }
    ], 
    "CommonPrefixes": [
        "1993/11/01/", 
        "1993/11/02/", 
        "1993/11/03/", 
        "1993/11/04/", 
        "1993/11/05/", 
        "1993/11/06/", 
        "1993/11/07/", 
        "1993/11/08/", 
        "1993/11/09/", 
        "1993/11/10/", 
        "1993/11/11/", 
        "1993/11/12/", 
        "1993/11/13/", 
        "1993/11/14/", 
        "1993/11/15/", 
        "1993/11/16/", 
        "1993/11/17/", 
        "1993/11/18/", 
        "1993/11/19/", 
        "1993/11/20/", 
        "1993/11/21/", 
        "1993/11/22/", 
        "1993/11/23/", 
        "1993/11/24/", 
        "1993/11/25/", 
        "1993/11/26/", 
        "1993/11/27/", 
        "1993/11/28/", 
        "1993/11/29/", 
        "1993/11/30/"
    ]
}
