{
    "Keys": [
        {
            "ETag": "\"d41d8cd98f00b204e9800998ecf8427e\"", 
            "Key": "2007/02/", 
            "Size": 0
        }
    ], 
    "CommonPrefixes": [
        "2007/02/01/", 
        "2007/02/02/", 
        "2007/02/03/", 
        "2007/02/04/", 
        "2007/02/05/", 
        "2007/02/06/", 
        "2007/02/07/", 
        "2007/02/08/", 
        "2007/02/09/", 
        "2007/02/10/", 
        "2007/02/11/", 
        "2007/02/12/", 
        "2007/02/13/", 
        "2007/02/14/", 
        "2007/02/15/", 
        "2007/02/16/", 
        "2007/02/17/", 
        "2007/02/18/", 
        "2007/02/19/", 
        "2007/02/20/", 
        "2007/02/21/", 
        "2007/02/22/", 
        "2007/02/23/", 
        "2007/02/24/", 
        "2007/02/25/", 
        "2007/02/26/", 
        "2007/02/27/", 
        "2007/02/28/"
    ]
}
