{
    "Keys": [
        {
            "ETag": "\"d41d8cd98f00b204e9800998ecf8427e\"", 
            "Key": "2002/11/", 
            "Size": 0
        }
    ], 
    "CommonPrefixes": [
        "2002/11/01/", 
        "2002/11/02/", 
        "2002/11/03/", 
        "2002/11/04/", 
        "2002/11/05/", 
        "2002/11/06/", 
        "2002/11/07/", 
        "2002/11/08/", 
        "2002/11/09/", 
        "2002/11/10/", 
        "2002/11/11/", 
        "2002/11/12/", 
        "2002/11/13/", 
        "2002/11/14/", 
        "2002/11/15/", 
        "2002/11/16/", 
        "2002/11/17/", 
        "2002/11/18/", 
        "2002/11/19/", 
        "2002/11/20/", 
        "2002/11/21/", 
        "2002/11/22/", 
        "2002/11/23/", 
        "2002/11/24/", 
        "2002/11/25/", 
        "2002/11/26/", 
        "2002/11/27/", 
        "2002/11/28/", 
        "2002/11/29/", 
        "2002/11/30/"
    ]
}
