{
    "Keys": [
        {
            "ETag": "\"d41d8cd98f00b204e9800998ecf8427e\"", 
            "Key": "2000/07/", 
            "Size": 0
        }
    ], 
    "CommonPrefixes": [
        "2000/07/01/", 
        "2000/07/02/", 
        "2000/07/03/", 
        "2000/07/04/", 
        "2000/07/05/", 
        "2000/07/06/", 
        "2000/07/07/", 
        "2000/07/08/", 
        "2000/07/09/", 
        "2000/07/10/", 
        "2000/07/11/", 
        "2000/07/12/", 
        "2000/07/13/", 
        "2000/07/14/", 
        "2000/07/15/", 
        "2000/07/16/", 
        "2000/07/17/", 
        "2000/07/18/", 
        "2000/07/19/", 
        "2000/07/20/", 
        "2000/07/21/", 
        "2000/07/22/", 
        "2000/07/23/", 
        "2000/07/24/", 
        "2000/07/25/", 
        "2000/07/26/", 
        "2000/07/27/", 
        "2000/07/28/", 
        "2000/07/29/", 
        "2000/07/30/", 
        "2000/07/31/"
    ]
}
