{
    "Keys": [
        {
            "ETag": "\"d41d8cd98f00b204e9800998ecf8427e\"", 
            "Key": "1991/10/", 
            "Size": 0
        }
    ], 
    "CommonPrefixes": [
        "1991/10/04/", 
        "1991/10/05/", 
        "1991/10/14/", 
        "1991/10/15/", 
        "1991/10/16/", 
        "1991/10/18/", 
        "1991/10/19/", 
        "1991/10/22/", 
        "1991/10/23/", 
        "1991/10/24/", 
        "1991/10/25/", 
        "1991/10/26/", 
        "1991/10/27/", 
        "1991/10/28/", 
        "1991/10/29/", 
        "1991/10/30/", 
        "1991/10/31/"
    ]
}
