{
    "Keys": [
        {
            "ETag": "\"d41d8cd98f00b204e9800998ecf8427e\"", 
            "Key": "2001/05/", 
            "Size": 0
        }
    ], 
    "CommonPrefixes": [
        "2001/05/01/", 
        "2001/05/02/", 
        "2001/05/03/", 
        "2001/05/04/", 
        "2001/05/05/", 
        "2001/05/06/", 
        "2001/05/07/", 
        "2001/05/08/", 
        "2001/05/09/", 
        "2001/05/10/", 
        "2001/05/11/", 
        "2001/05/12/", 
        "2001/05/13/", 
        "2001/05/14/", 
        "2001/05/15/", 
        "2001/05/16/", 
        "2001/05/17/", 
        "2001/05/18/", 
        "2001/05/19/", 
        "2001/05/20/", 
        "2001/05/21/", 
        "2001/05/22/", 
        "2001/05/23/", 
        "2001/05/24/", 
        "2001/05/25/", 
        "2001/05/26/", 
        "2001/05/27/", 
        "2001/05/28/", 
        "2001/05/29/", 
        "2001/05/30/", 
        "2001/05/31/"
    ]
}
