{
    "Keys": [
        {
            "ETag": "\"d41d8cd98f00b204e9800998ecf8427e\"", 
            "Key": "2005/03/", 
            "Size": 0
        }
    ], 
    "CommonPrefixes": [
        "2005/03/01/", 
        "2005/03/02/", 
        "2005/03/03/", 
        "2005/03/04/", 
        "2005/03/05/", 
        "2005/03/06/", 
        "2005/03/07/", 
        "2005/03/08/", 
        "2005/03/09/", 
        "2005/03/10/", 
        "2005/03/11/", 
        "2005/03/12/", 
        "2005/03/13/", 
        "2005/03/14/", 
        "2005/03/15/", 
        "2005/03/16/", 
        "2005/03/17/", 
        "2005/03/18/", 
        "2005/03/19/", 
        "2005/03/20/", 
        "2005/03/21/", 
        "2005/03/22/", 
        "2005/03/23/", 
        "2005/03/24/", 
        "2005/03/25/", 
        "2005/03/26/", 
        "2005/03/27/", 
        "2005/03/28/", 
        "2005/03/29/", 
        "2005/03/30/", 
        "2005/03/31/"
    ]
}
