{
    "Keys": [
        {
            "ETag": "\"d41d8cd98f00b204e9800998ecf8427e\"", 
            "Key": "2003/07/", 
            "Size": 0
        }
    ], 
    "CommonPrefixes": [
        "2003/07/01/", 
        "2003/07/02/", 
        "2003/07/03/", 
        "2003/07/04/", 
        "2003/07/05/", 
        "2003/07/06/", 
        "2003/07/07/", 
        "2003/07/08/", 
        "2003/07/09/", 
        "2003/07/10/", 
        "2003/07/11/", 
        "2003/07/12/", 
        "2003/07/13/", 
        "2003/07/14/", 
        "2003/07/15/", 
        "2003/07/16/", 
        "2003/07/17/", 
        "2003/07/18/", 
        "2003/07/19/", 
        "2003/07/20/", 
        "2003/07/21/", 
        "2003/07/22/", 
        "2003/07/23/", 
        "2003/07/24/", 
        "2003/07/25/", 
        "2003/07/26/", 
        "2003/07/27/", 
        "2003/07/28/", 
        "2003/07/29/", 
        "2003/07/30/", 
        "2003/07/31/"
    ]
}
