{
    "Keys": [
        {
            "ETag": "\"d41d8cd98f00b204e9800998ecf8427e\"", 
            "Key": "1995/08/", 
            "Size": 0
        }
    ], 
    "CommonPrefixes": [
        "1995/08/01/", 
        "1995/08/02/", 
        "1995/08/03/", 
        "1995/08/04/", 
        "1995/08/05/", 
        "1995/08/06/", 
        "1995/08/07/", 
        "1995/08/08/", 
        "1995/08/09/", 
        "1995/08/10/", 
        "1995/08/11/", 
        "1995/08/12/", 
        "1995/08/13/", 
        "1995/08/14/", 
        "1995/08/15/", 
        "1995/08/16/", 
        "1995/08/17/", 
        "1995/08/18/", 
        "1995/08/19/", 
        "1995/08/20/", 
        "1995/08/21/", 
        "1995/08/22/", 
        "1995/08/23/", 
        "1995/08/24/", 
        "1995/08/25/", 
        "1995/08/26/", 
        "1995/08/27/", 
        "1995/08/28/", 
        "1995/08/29/", 
        "1995/08/30/", 
        "1995/08/31/"
    ]
}
