{
    "Keys": [
        {
            "ETag": "\"d41d8cd98f00b204e9800998ecf8427e\"", 
            "Key": "2003/12/", 
            "Size": 0
        }
    ], 
    "CommonPrefixes": [
        "2003/12/01/", 
        "2003/12/02/", 
        "2003/12/03/", 
        "2003/12/04/", 
        "2003/12/05/", 
        "2003/12/06/", 
        "2003/12/07/", 
        "2003/12/08/", 
        "2003/12/09/", 
        "2003/12/10/", 
        "2003/12/11/", 
        "2003/12/12/", 
        "2003/12/13/", 
        "2003/12/14/", 
        "2003/12/15/", 
        "2003/12/16/", 
        "2003/12/17/", 
        "2003/12/18/", 
        "2003/12/19/", 
        "2003/12/20/", 
        "2003/12/21/", 
        "2003/12/22/", 
        "2003/12/23/", 
        "2003/12/24/", 
        "2003/12/25/", 
        "2003/12/26/", 
        "2003/12/27/", 
        "2003/12/28/", 
        "2003/12/29/", 
        "2003/12/30/", 
        "2003/12/31/"
    ]
}
