{
    "Keys": null, 
    "CommonPrefixes": [
        "2015/07/01/", 
        "2015/07/02/", 
        "2015/07/03/", 
        "2015/07/04/", 
        "2015/07/05/", 
        "2015/07/06/", 
        "2015/07/07/", 
        "2015/07/08/", 
        "2015/07/09/", 
        "2015/07/10/", 
        "2015/07/11/", 
        "2015/07/12/", 
        "2015/07/13/", 
        "2015/07/14/", 
        "2015/07/15/", 
        "2015/07/16/", 
        "2015/07/17/", 
        "2015/07/18/", 
        "2015/07/19/", 
        "2015/07/20/", 
        "2015/07/21/", 
        "2015/07/22/", 
        "2015/07/23/", 
        "2015/07/24/", 
        "2015/07/25/", 
        "2015/07/26/", 
        "2015/07/27/", 
        "2015/07/28/", 
        "2015/07/29/", 
        "2015/07/30/", 
        "2015/07/31/"
    ]
}
