{
    "Keys": [
        {
            "ETag": "\"d41d8cd98f00b204e9800998ecf8427e\"", 
            "Key": "1991/01/", 
            "Size": 0
        }
    ], 
    "CommonPrefixes": [
        "1991/01/01/", 
        "1991/01/02/", 
        "1991/01/03/", 
        "1991/01/04/", 
        "1991/01/05/", 
        "1991/01/06/", 
        "1991/01/07/", 
        "1991/01/08/", 
        "1991/01/09/", 
        "1991/01/10/", 
        "1991/01/11/", 
        "1991/01/12/", 
        "1991/01/13/", 
        "1991/01/14/", 
        "1991/01/15/", 
        "1991/01/16/", 
        "1991/01/17/", 
        "1991/01/18/", 
        "1991/01/19/", 
        "1991/01/20/", 
        "1991/01/21/", 
        "1991/01/22/", 
        "1991/01/23/", 
        "1991/01/24/", 
        "1991/01/25/", 
        "1991/01/26/", 
        "1991/01/27/", 
        "1991/01/28/", 
        "1991/01/29/", 
        "1991/01/30/", 
        "1991/01/31/"
    ]
}
