{
    "Keys": [
        {
            "ETag": "\"d41d8cd98f00b204e9800998ecf8427e\"", 
            "Key": "1992/08/", 
            "Size": 0
        }
    ], 
    "CommonPrefixes": [
        "1992/08/01/", 
        "1992/08/02/", 
        "1992/08/03/", 
        "1992/08/04/", 
        "1992/08/06/", 
        "1992/08/07/", 
        "1992/08/08/", 
        "1992/08/09/", 
        "1992/08/10/", 
        "1992/08/11/", 
        "1992/08/12/", 
        "1992/08/13/", 
        "1992/08/14/", 
        "1992/08/15/", 
        "1992/08/16/", 
        "1992/08/17/", 
        "1992/08/18/", 
        "1992/08/19/", 
        "1992/08/20/", 
        "1992/08/21/", 
        "1992/08/22/", 
        "1992/08/23/", 
        "1992/08/24/", 
        "1992/08/25/", 
        "1992/08/26/", 
        "1992/08/27/", 
        "1992/08/28/", 
        "1992/08/29/", 
        "1992/08/30/", 
        "1992/08/31/"
    ]
}
