{
    "Keys": [
        {
            "ETag": "\"d41d8cd98f00b204e9800998ecf8427e\"", 
            "Key": "1992/07/", 
            "Size": 0
        }
    ], 
    "CommonPrefixes": [
        "1992/07/02/", 
        "1992/07/03/", 
        "1992/07/04/", 
        "1992/07/05/", 
        "1992/07/08/", 
        "1992/07/10/", 
        "1992/07/11/", 
        "1992/07/12/", 
        "1992/07/13/", 
        "1992/07/14/", 
        "1992/07/15/", 
        "1992/07/16/", 
        "1992/07/17/", 
        "1992/07/18/", 
        "1992/07/19/", 
        "1992/07/26/", 
        "1992/07/27/", 
        "1992/07/28/", 
        "1992/07/29/", 
        "1992/07/30/", 
        "1992/07/31/"
    ]
}
