{
    "Keys": [
        {
            "ETag": "\"d41d8cd98f00b204e9800998ecf8427e\"", 
            "Key": "2013/03/", 
            "Size": 0
        }
    ], 
    "CommonPrefixes": [
        "2013/03/01/", 
        "2013/03/02/", 
        "2013/03/03/", 
        "2013/03/04/", 
        "2013/03/05/", 
        "2013/03/06/", 
        "2013/03/07/", 
        "2013/03/08/", 
        "2013/03/09/", 
        "2013/03/10/", 
        "2013/03/11/", 
        "2013/03/12/", 
        "2013/03/13/", 
        "2013/03/14/", 
        "2013/03/15/", 
        "2013/03/16/", 
        "2013/03/17/", 
        "2013/03/18/", 
        "2013/03/19/", 
        "2013/03/20/", 
        "2013/03/21/", 
        "2013/03/22/", 
        "2013/03/23/", 
        "2013/03/24/", 
        "2013/03/25/", 
        "2013/03/26/", 
        "2013/03/27/", 
        "2013/03/28/", 
        "2013/03/29/", 
        "2013/03/30/", 
        "2013/03/31/"
    ]
}
