{
    "Keys": [
        {
            "ETag": "\"d41d8cd98f00b204e9800998ecf8427e\"", 
            "Key": "1997/12/", 
            "Size": 0
        }
    ], 
    "CommonPrefixes": [
        "1997/12/01/", 
        "1997/12/02/", 
        "1997/12/03/", 
        "1997/12/04/", 
        "1997/12/05/", 
        "1997/12/06/", 
        "1997/12/07/", 
        "1997/12/08/", 
        "1997/12/09/", 
        "1997/12/10/", 
        "1997/12/11/", 
        "1997/12/12/", 
        "1997/12/13/", 
        "1997/12/14/", 
        "1997/12/15/", 
        "1997/12/16/", 
        "1997/12/17/", 
        "1997/12/18/", 
        "1997/12/19/", 
        "1997/12/20/", 
        "1997/12/21/", 
        "1997/12/22/", 
        "1997/12/23/", 
        "1997/12/24/", 
        "1997/12/25/", 
        "1997/12/26/", 
        "1997/12/27/", 
        "1997/12/28/", 
        "1997/12/29/", 
        "1997/12/30/", 
        "1997/12/31/"
    ]
}
