{
    "Keys": [
        {
            "ETag": "\"d41d8cd98f00b204e9800998ecf8427e\"", 
            "Key": "2006/05/", 
            "Size": 0
        }
    ], 
    "CommonPrefixes": [
        "2006/05/01/", 
        "2006/05/02/", 
        "2006/05/03/", 
        "2006/05/04/", 
        "2006/05/05/", 
        "2006/05/06/", 
        "2006/05/07/", 
        "2006/05/08/", 
        "2006/05/09/", 
        "2006/05/10/", 
        "2006/05/11/", 
        "2006/05/12/", 
        "2006/05/13/", 
        "2006/05/14/", 
        "2006/05/15/", 
        "2006/05/16/", 
        "2006/05/17/", 
        "2006/05/18/", 
        "2006/05/19/", 
        "2006/05/20/", 
        "2006/05/21/", 
        "2006/05/22/", 
        "2006/05/23/", 
        "2006/05/24/", 
        "2006/05/25/", 
        "2006/05/26/", 
        "2006/05/27/", 
        "2006/05/28/", 
        "2006/05/29/", 
        "2006/05/30/", 
        "2006/05/31/"
    ]
}
