{
    "Keys": [
        {
            "ETag": "\"d41d8cd98f00b204e9800998ecf8427e\"", 
            "Key": "1994/08/", 
            "Size": 0
        }
    ], 
    "CommonPrefixes": [
        "1994/08/01/", 
        "1994/08/02/", 
        "1994/08/03/", 
        "1994/08/04/", 
        "1994/08/05/", 
        "1994/08/06/", 
        "1994/08/07/", 
        "1994/08/08/", 
        "1994/08/09/", 
        "1994/08/10/", 
        "1994/08/11/", 
        "1994/08/12/", 
        "1994/08/13/", 
        "1994/08/14/", 
        "1994/08/15/", 
        "1994/08/16/", 
        "1994/08/17/", 
        "1994/08/18/", 
        "1994/08/19/", 
        "1994/08/20/", 
        "1994/08/21/", 
        "1994/08/22/", 
        "1994/08/23/", 
        "1994/08/24/", 
        "1994/08/25/", 
        "1994/08/26/", 
        "1994/08/27/", 
        "1994/08/28/", 
        "1994/08/29/", 
        "1994/08/30/", 
        "1994/08/31/"
    ]
}
