{
    "Keys": [
        {
            "ETag": "\"d41d8cd98f00b204e9800998ecf8427e\"", 
            "Key": "2013/09/", 
            "Size": 0
        }
    ], 
    "CommonPrefixes": [
        "2013/09/01/", 
        "2013/09/02/", 
        "2013/09/03/", 
        "2013/09/04/", 
        "2013/09/05/", 
        "2013/09/06/", 
        "2013/09/07/", 
        "2013/09/08/", 
        "2013/09/09/", 
        "2013/09/10/", 
        "2013/09/11/", 
        "2013/09/12/", 
        "2013/09/13/", 
        "2013/09/14/", 
        "2013/09/15/", 
        "2013/09/16/", 
        "2013/09/17/", 
        "2013/09/18/", 
        "2013/09/19/", 
        "2013/09/20/", 
        "2013/09/21/", 
        "2013/09/22/", 
        "2013/09/23/", 
        "2013/09/24/", 
        "2013/09/25/", 
        "2013/09/26/", 
        "2013/09/27/", 
        "2013/09/28/", 
        "2013/09/29/", 
        "2013/09/30/"
    ]
}
