{
    "Keys": [
        {
            "ETag": "\"d41d8cd98f00b204e9800998ecf8427e\"", 
            "Key": "2000/12/", 
            "Size": 0
        }
    ], 
    "CommonPrefixes": [
        "2000/12/01/", 
        "2000/12/02/", 
        "2000/12/03/", 
        "2000/12/04/", 
        "2000/12/05/", 
        "2000/12/06/", 
        "2000/12/07/", 
        "2000/12/08/", 
        "2000/12/09/", 
        "2000/12/10/", 
        "2000/12/11/", 
        "2000/12/12/", 
        "2000/12/13/", 
        "2000/12/14/", 
        "2000/12/15/", 
        "2000/12/16/", 
        "2000/12/17/", 
        "2000/12/18/", 
        "2000/12/19/", 
        "2000/12/20/", 
        "2000/12/21/", 
        "2000/12/22/", 
        "2000/12/23/", 
        "2000/12/24/", 
        "2000/12/25/", 
        "2000/12/26/", 
        "2000/12/27/", 
        "2000/12/28/", 
        "2000/12/29/", 
        "2000/12/30/", 
        "2000/12/31/"
    ]
}
