{
    "Keys": [
        {
            "ETag": "\"d41d8cd98f00b204e9800998ecf8427e\"", 
            "Key": "1998/12/", 
            "Size": 0
        }
    ], 
    "CommonPrefixes": [
        "1998/12/01/", 
        "1998/12/02/", 
        "1998/12/03/", 
        "1998/12/04/", 
        "1998/12/05/", 
        "1998/12/06/", 
        "1998/12/07/", 
        "1998/12/08/", 
        "1998/12/09/", 
        "1998/12/10/", 
        "1998/12/11/", 
        "1998/12/12/", 
        "1998/12/13/", 
        "1998/12/14/", 
        "1998/12/15/", 
        "1998/12/16/", 
        "1998/12/17/", 
        "1998/12/18/", 
        "1998/12/19/", 
        "1998/12/20/", 
        "1998/12/21/", 
        "1998/12/22/", 
        "1998/12/23/", 
        "1998/12/24/", 
        "1998/12/25/", 
        "1998/12/26/", 
        "1998/12/27/", 
        "1998/12/28/", 
        "1998/12/29/", 
        "1998/12/30/", 
        "1998/12/31/"
    ]
}
