{
    "Keys": [
        {
            "ETag": "\"d41d8cd98f00b204e9800998ecf8427e\"", 
            "Key": "2004/04/", 
            "Size": 0
        }
    ], 
    "CommonPrefixes": [
        "2004/04/01/", 
        "2004/04/02/", 
        "2004/04/03/", 
        "2004/04/04/", 
        "2004/04/05/", 
        "2004/04/06/", 
        "2004/04/07/", 
        "2004/04/08/", 
        "2004/04/09/", 
        "2004/04/10/", 
        "2004/04/11/", 
        "2004/04/12/", 
        "2004/04/13/", 
        "2004/04/14/", 
        "2004/04/15/", 
        "2004/04/16/", 
        "2004/04/17/", 
        "2004/04/18/", 
        "2004/04/19/", 
        "2004/04/20/", 
        "2004/04/21/", 
        "2004/04/22/", 
        "2004/04/23/", 
        "2004/04/24/", 
        "2004/04/25/", 
        "2004/04/26/", 
        "2004/04/27/", 
        "2004/04/28/", 
        "2004/04/29/", 
        "2004/04/30/"
    ]
}
