{
    "Keys": [
        {
            "ETag": "\"d41d8cd98f00b204e9800998ecf8427e\"", 
            "Key": "1998/02/", 
            "Size": 0
        }
    ], 
    "CommonPrefixes": [
        "1998/02/01/", 
        "1998/02/02/", 
        "1998/02/03/", 
        "1998/02/04/", 
        "1998/02/05/", 
        "1998/02/06/", 
        "1998/02/07/", 
        "1998/02/08/", 
        "1998/02/09/", 
        "1998/02/10/", 
        "1998/02/11/", 
        "1998/02/12/", 
        "1998/02/13/", 
        "1998/02/14/", 
        "1998/02/15/", 
        "1998/02/16/", 
        "1998/02/17/", 
        "1998/02/18/", 
        "1998/02/19/", 
        "1998/02/20/", 
        "1998/02/21/", 
        "1998/02/22/", 
        "1998/02/23/", 
        "1998/02/24/", 
        "1998/02/25/", 
        "1998/02/26/", 
        "1998/02/27/", 
        "1998/02/28/"
    ]
}
