{
    "Keys": [
        {
            "ETag": "\"d41d8cd98f00b204e9800998ecf8427e\"", 
            "Key": "1992/09/", 
            "Size": 0
        }
    ], 
    "CommonPrefixes": [
        "1992/09/01/", 
        "1992/09/02/", 
        "1992/09/03/", 
        "1992/09/04/", 
        "1992/09/05/", 
        "1992/09/06/", 
        "1992/09/07/", 
        "1992/09/08/", 
        "1992/09/09/", 
        "1992/09/10/", 
        "1992/09/11/", 
        "1992/09/12/", 
        "1992/09/13/", 
        "1992/09/14/", 
        "1992/09/15/", 
        "1992/09/16/", 
        "1992/09/17/", 
        "1992/09/18/", 
        "1992/09/19/", 
        "1992/09/21/", 
        "1992/09/22/", 
        "1992/09/23/", 
        "1992/09/24/", 
        "1992/09/25/", 
        "1992/09/26/", 
        "1992/09/27/", 
        "1992/09/28/", 
        "1992/09/29/", 
        "1992/09/30/"
    ]
}
