{
    "Keys": [
        {
            "ETag": "\"d41d8cd98f00b204e9800998ecf8427e\"", 
            "Key": "2000/11/", 
            "Size": 0
        }
    ], 
    "CommonPrefixes": [
        "2000/11/01/", 
        "2000/11/02/", 
        "2000/11/03/", 
        "2000/11/04/", 
        "2000/11/05/", 
        "2000/11/06/", 
        "2000/11/07/", 
        "2000/11/08/", 
        "2000/11/09/", 
        "2000/11/10/", 
        "2000/11/11/", 
        "2000/11/12/", 
        "2000/11/13/", 
        "2000/11/14/", 
        "2000/11/15/", 
        "2000/11/16/", 
        "2000/11/17/", 
        "2000/11/18/", 
        "2000/11/19/", 
        "2000/11/20/", 
        "2000/11/21/", 
        "2000/11/22/", 
        "2000/11/23/", 
        "2000/11/24/", 
        "2000/11/25/", 
        "2000/11/26/", 
        "2000/11/27/", 
        "2000/11/28/", 
        "2000/11/29/", 
        "2000/11/30/"
    ]
}
