{
    "Keys": [
        {
            "ETag": "\"d41d8cd98f00b204e9800998ecf8427e\"", 
            "Key": "2007/03/", 
            "Size": 0
        }
    ], 
    "CommonPrefixes": [
        "2007/03/01/", 
        "2007/03/02/", 
        "2007/03/03/", 
        "2007/03/04/", 
        "2007/03/05/", 
        "2007/03/06/", 
        "2007/03/07/", 
        "2007/03/08/", 
        "2007/03/09/", 
        "2007/03/10/", 
        "2007/03/11/", 
        "2007/03/12/", 
        "2007/03/13/", 
        "2007/03/14/", 
        "2007/03/15/", 
        "2007/03/16/", 
        "2007/03/17/", 
        "2007/03/18/", 
        "2007/03/19/", 
        "2007/03/20/", 
        "2007/03/21/", 
        "2007/03/22/", 
        "2007/03/23/", 
        "2007/03/24/", 
        "2007/03/25/", 
        "2007/03/26/", 
        "2007/03/27/", 
        "2007/03/28/", 
        "2007/03/29/", 
        "2007/03/30/", 
        "2007/03/31/"
    ]
}
