{
    "Keys": null, 
    "CommonPrefixes": [
        "2014/03/01/", 
        "2014/03/02/", 
        "2014/03/03/", 
        "2014/03/04/", 
        "2014/03/05/", 
        "2014/03/06/", 
        "2014/03/07/", 
        "2014/03/08/", 
        "2014/03/09/", 
        "2014/03/10/", 
        "2014/03/11/", 
        "2014/03/12/", 
        "2014/03/13/", 
        "2014/03/14/", 
        "2014/03/15/", 
        "2014/03/16/", 
        "2014/03/17/", 
        "2014/03/18/", 
        "2014/03/19/", 
        "2014/03/20/", 
        "2014/03/21/", 
        "2014/03/22/", 
        "2014/03/23/", 
        "2014/03/24/", 
        "2014/03/25/", 
        "2014/03/26/", 
        "2014/03/27/", 
        "2014/03/28/", 
        "2014/03/29/", 
        "2014/03/30/", 
        "2014/03/31/"
    ]
}
