{
    "Keys": [
        {
            "ETag": "\"d41d8cd98f00b204e9800998ecf8427e\"", 
            "Key": "2000/02/", 
            "Size": 0
        }
    ], 
    "CommonPrefixes": [
        "2000/02/01/", 
        "2000/02/02/", 
        "2000/02/03/", 
        "2000/02/04/", 
        "2000/02/05/", 
        "2000/02/06/", 
        "2000/02/07/", 
        "2000/02/08/", 
        "2000/02/09/", 
        "2000/02/10/", 
        "2000/02/11/", 
        "2000/02/12/", 
        "2000/02/13/", 
        "2000/02/14/", 
        "2000/02/15/", 
        "2000/02/16/", 
        "2000/02/17/", 
        "2000/02/18/", 
        "2000/02/19/", 
        "2000/02/20/", 
        "2000/02/21/", 
        "2000/02/22/", 
        "2000/02/23/", 
        "2000/02/24/", 
        "2000/02/25/", 
        "2000/02/26/", 
        "2000/02/27/", 
        "2000/02/28/", 
        "2000/02/29/"
    ]
}
