{
    "Keys": [
        {
            "ETag": "\"d41d8cd98f00b204e9800998ecf8427e\"", 
            "Key": "2004/09/", 
            "Size": 0
        }
    ], 
    "CommonPrefixes": [
        "2004/09/01/", 
        "2004/09/02/", 
        "2004/09/03/", 
        "2004/09/04/", 
        "2004/09/05/", 
        "2004/09/06/", 
        "2004/09/07/", 
        "2004/09/08/", 
        "2004/09/09/", 
        "2004/09/10/", 
        "2004/09/11/", 
        "2004/09/12/", 
        "2004/09/13/", 
        "2004/09/14/", 
        "2004/09/15/", 
        "2004/09/16/", 
        "2004/09/17/", 
        "2004/09/18/", 
        "2004/09/19/", 
        "2004/09/20/", 
        "2004/09/21/", 
        "2004/09/22/", 
        "2004/09/23/", 
        "2004/09/24/", 
        "2004/09/25/", 
        "2004/09/26/", 
        "2004/09/27/", 
        "2004/09/28/", 
        "2004/09/29/", 
        "2004/09/30/"
    ]
}
