{
    "Keys": [
        {
            "ETag": "\"d41d8cd98f00b204e9800998ecf8427e\"", 
            "Key": "1995/02/", 
            "Size": 0
        }
    ], 
    "CommonPrefixes": [
        "1995/02/01/", 
        "1995/02/02/", 
        "1995/02/03/", 
        "1995/02/04/", 
        "1995/02/05/", 
        "1995/02/06/", 
        "1995/02/07/", 
        "1995/02/08/", 
        "1995/02/09/", 
        "1995/02/10/", 
        "1995/02/11/", 
        "1995/02/12/", 
        "1995/02/13/", 
        "1995/02/14/", 
        "1995/02/15/", 
        "1995/02/16/", 
        "1995/02/17/", 
        "1995/02/18/", 
        "1995/02/19/", 
        "1995/02/20/", 
        "1995/02/21/", 
        "1995/02/22/", 
        "1995/02/23/", 
        "1995/02/24/", 
        "1995/02/25/", 
        "1995/02/26/", 
        "1995/02/27/", 
        "1995/02/28/"
    ]
}
