{
    "Keys": [
        {
            "ETag": "\"d41d8cd98f00b204e9800998ecf8427e\"", 
            "Key": "1999/08/", 
            "Size": 0
        }
    ], 
    "CommonPrefixes": [
        "1999/08/01/", 
        "1999/08/02/", 
        "1999/08/03/", 
        "1999/08/04/", 
        "1999/08/05/", 
        "1999/08/06/", 
        "1999/08/07/", 
        "1999/08/08/", 
        "1999/08/09/", 
        "1999/08/10/", 
        "1999/08/11/", 
        "1999/08/12/", 
        "1999/08/13/", 
        "1999/08/14/", 
        "1999/08/15/", 
        "1999/08/16/", 
        "1999/08/17/", 
        "1999/08/18/", 
        "1999/08/19/", 
        "1999/08/20/", 
        "1999/08/21/", 
        "1999/08/22/", 
        "1999/08/23/", 
        "1999/08/24/", 
        "1999/08/25/", 
        "1999/08/26/", 
        "1999/08/27/", 
        "1999/08/28/", 
        "1999/08/29/", 
        "1999/08/30/", 
        "1999/08/31/"
    ]
}
