{
    "Keys": null, 
    "CommonPrefixes": [
        "2015/02/01/", 
        "2015/02/02/", 
        "2015/02/03/", 
        "2015/02/04/", 
        "2015/02/05/", 
        "2015/02/06/", 
        "2015/02/07/", 
        "2015/02/08/", 
        "2015/02/09/", 
        "2015/02/10/", 
        "2015/02/11/", 
        "2015/02/12/", 
        "2015/02/13/", 
        "2015/02/14/", 
        "2015/02/15/", 
        "2015/02/16/", 
        "2015/02/17/", 
        "2015/02/18/", 
        "2015/02/19/", 
        "2015/02/20/", 
        "2015/02/21/", 
        "2015/02/22/", 
        "2015/02/23/", 
        "2015/02/24/", 
        "2015/02/25/", 
        "2015/02/26/", 
        "2015/02/27/", 
        "2015/02/28/"
    ]
}
