{
    "Keys": [
        {
            "ETag": "\"d41d8cd98f00b204e9800998ecf8427e\"", 
            "Key": "2002/01/", 
            "Size": 0
        }
    ], 
    "CommonPrefixes": [
        "2002/01/01/", 
        "2002/01/02/", 
        "2002/01/03/", 
        "2002/01/04/", 
        "2002/01/05/", 
        "2002/01/06/", 
        "2002/01/07/", 
        "2002/01/08/", 
        "2002/01/09/", 
        "2002/01/10/", 
        "2002/01/11/", 
        "2002/01/12/", 
        "2002/01/13/", 
        "2002/01/14/", 
        "2002/01/15/", 
        "2002/01/16/", 
        "2002/01/17/", 
        "2002/01/18/", 
        "2002/01/19/", 
        "2002/01/20/", 
        "2002/01/21/", 
        "2002/01/22/", 
        "2002/01/23/", 
        "2002/01/24/", 
        "2002/01/25/", 
        "2002/01/26/", 
        "2002/01/27/", 
        "2002/01/28/", 
        "2002/01/29/", 
        "2002/01/30/", 
        "2002/01/31/"
    ]
}
