{
    "Keys": [
        {
            "ETag": "\"d41d8cd98f00b204e9800998ecf8427e\"", 
            "Key": "2006/02/", 
            "Size": 0
        }
    ], 
    "CommonPrefixes": [
        "2006/02/01/", 
        "2006/02/02/", 
        "2006/02/03/", 
        "2006/02/04/", 
        "2006/02/05/", 
        "2006/02/06/", 
        "2006/02/07/", 
        "2006/02/08/", 
        "2006/02/09/", 
        "2006/02/10/", 
        "2006/02/11/", 
        "2006/02/12/", 
        "2006/02/13/", 
        "2006/02/14/", 
        "2006/02/15/", 
        "2006/02/16/", 
        "2006/02/17/", 
        "2006/02/18/", 
        "2006/02/19/", 
        "2006/02/20/", 
        "2006/02/21/", 
        "2006/02/22/", 
        "2006/02/23/", 
        "2006/02/24/", 
        "2006/02/25/", 
        "2006/02/26/", 
        "2006/02/27/", 
        "2006/02/28/"
    ]
}
