{
    "Keys": [
        {
            "ETag": "\"d41d8cd98f00b204e9800998ecf8427e\"", 
            "Key": "2003/02/", 
            "Size": 0
        }
    ], 
    "CommonPrefixes": [
        "2003/02/01/", 
        "2003/02/02/", 
        "2003/02/03/", 
        "2003/02/04/", 
        "2003/02/05/", 
        "2003/02/06/", 
        "2003/02/07/", 
        "2003/02/08/", 
        "2003/02/09/", 
        "2003/02/10/", 
        "2003/02/11/", 
        "2003/02/12/", 
        "2003/02/13/", 
        "2003/02/14/", 
        "2003/02/15/", 
        "2003/02/16/", 
        "2003/02/17/", 
        "2003/02/18/", 
        "2003/02/19/", 
        "2003/02/20/", 
        "2003/02/21/", 
        "2003/02/22/", 
        "2003/02/23/", 
        "2003/02/24/", 
        "2003/02/25/", 
        "2003/02/26/", 
        "2003/02/27/", 
        "2003/02/28/"
    ]
}
