{
    "Keys": null, 
    "CommonPrefixes": [
        "2015/09/01/", 
        "2015/09/02/", 
        "2015/09/03/", 
        "2015/09/04/", 
        "2015/09/05/", 
        "2015/09/06/", 
        "2015/09/07/", 
        "2015/09/08/", 
        "2015/09/09/", 
        "2015/09/10/", 
        "2015/09/11/", 
        "2015/09/12/", 
        "2015/09/13/", 
        "2015/09/14/", 
        "2015/09/15/", 
        "2015/09/16/", 
        "2015/09/17/", 
        "2015/09/18/", 
        "2015/09/19/", 
        "2015/09/20/", 
        "2015/09/21/", 
        "2015/09/23/", 
        "2015/09/24/", 
        "2015/09/25/", 
        "2015/09/26/", 
        "2015/09/27/", 
        "2015/09/28/", 
        "2015/09/29/", 
        "2015/09/30/"
    ]
}
