{
    "Keys": [
        {
            "ETag": "\"d41d8cd98f00b204e9800998ecf8427e\"", 
            "Key": "1996/08/", 
            "Size": 0
        }
    ], 
    "CommonPrefixes": [
        "1996/08/01/", 
        "1996/08/02/", 
        "1996/08/03/", 
        "1996/08/04/", 
        "1996/08/05/", 
        "1996/08/06/", 
        "1996/08/07/", 
        "1996/08/08/", 
        "1996/08/09/", 
        "1996/08/10/", 
        "1996/08/11/", 
        "1996/08/12/", 
        "1996/08/13/", 
        "1996/08/14/", 
        "1996/08/15/", 
        "1996/08/16/", 
        "1996/08/17/", 
        "1996/08/18/", 
        "1996/08/19/", 
        "1996/08/20/", 
        "1996/08/21/", 
        "1996/08/22/", 
        "1996/08/23/", 
        "1996/08/24/", 
        "1996/08/25/", 
        "1996/08/26/", 
        "1996/08/27/", 
        "1996/08/28/", 
        "1996/08/29/", 
        "1996/08/30/", 
        "1996/08/31/"
    ]
}
