{
    "Keys": [
        {
            "ETag": "\"d41d8cd98f00b204e9800998ecf8427e\"", 
            "Key": "1999/03/", 
            "Size": 0
        }
    ], 
    "CommonPrefixes": [
        "1999/03/01/", 
        "1999/03/02/", 
        "1999/03/03/", 
        "1999/03/04/", 
        "1999/03/05/", 
        "1999/03/06/", 
        "1999/03/07/", 
        "1999/03/08/", 
        "1999/03/09/", 
        "1999/03/10/", 
        "1999/03/11/", 
        "1999/03/12/", 
        "1999/03/13/", 
        "1999/03/14/", 
        "1999/03/15/", 
        "1999/03/16/", 
        "1999/03/17/", 
        "1999/03/18/", 
        "1999/03/19/", 
        "1999/03/20/", 
        "1999/03/21/", 
        "1999/03/22/", 
        "1999/03/23/", 
        "1999/03/24/", 
        "1999/03/25/", 
        "1999/03/26/", 
        "1999/03/27/", 
        "1999/03/28/", 
        "1999/03/29/", 
        "1999/03/30/", 
        "1999/03/31/"
    ]
}
