{
    "Keys": [
        {
            "ETag": "\"d41d8cd98f00b204e9800998ecf8427e\"", 
            "Key": "2012/11/", 
            "Size": 0
        }
    ], 
    "CommonPrefixes": [
        "2012/11/01/", 
        "2012/11/02/", 
        "2012/11/03/", 
        "2012/11/04/", 
        "2012/11/05/", 
        "2012/11/06/", 
        "2012/11/07/", 
        "2012/11/08/", 
        "2012/11/09/", 
        "2012/11/10/", 
        "2012/11/11/", 
        "2012/11/12/", 
        "2012/11/13/", 
        "2012/11/14/", 
        "2012/11/15/", 
        "2012/11/16/", 
        "2012/11/17/", 
        "2012/11/18/", 
        "2012/11/19/", 
        "2012/11/20/", 
        "2012/11/21/", 
        "2012/11/22/", 
        "2012/11/23/", 
        "2012/11/24/", 
        "2012/11/25/", 
        "2012/11/26/", 
        "2012/11/27/", 
        "2012/11/28/", 
        "2012/11/29/", 
        "2012/11/30/"
    ]
}
