{
    "Keys": [
        {
            "ETag": "\"d41d8cd98f00b204e9800998ecf8427e\"", 
            "Key": "1992/04/", 
            "Size": 0
        }
    ], 
    "CommonPrefixes": [
        "1992/04/01/", 
        "1992/04/02/", 
        "1992/04/03/", 
        "1992/04/04/", 
        "1992/04/05/", 
        "1992/04/08/", 
        "1992/04/09/", 
        "1992/04/10/", 
        "1992/04/15/", 
        "1992/04/16/", 
        "1992/04/17/", 
        "1992/04/18/", 
        "1992/04/19/", 
        "1992/04/20/", 
        "1992/04/21/", 
        "1992/04/22/", 
        "1992/04/23/", 
        "1992/04/24/", 
        "1992/04/25/", 
        "1992/04/26/", 
        "1992/04/27/", 
        "1992/04/28/", 
        "1992/04/29/", 
        "1992/04/30/"
    ]
}
