{
    "Keys": [
        {
            "ETag": "\"d41d8cd98f00b204e9800998ecf8427e\"", 
            "Key": "1996/05/", 
            "Size": 0
        }
    ], 
    "CommonPrefixes": [
        "1996/05/01/", 
        "1996/05/02/", 
        "1996/05/03/", 
        "1996/05/04/", 
        "1996/05/05/", 
        "1996/05/06/", 
        "1996/05/07/", 
        "1996/05/08/", 
        "1996/05/09/", 
        "1996/05/10/", 
        "1996/05/11/", 
        "1996/05/12/", 
        "1996/05/13/", 
        "1996/05/14/", 
        "1996/05/15/", 
        "1996/05/16/", 
        "1996/05/17/", 
        "1996/05/18/", 
        "1996/05/19/", 
        "1996/05/20/", 
        "1996/05/21/", 
        "1996/05/22/", 
        "1996/05/23/", 
        "1996/05/24/", 
        "1996/05/25/", 
        "1996/05/26/", 
        "1996/05/27/", 
        "1996/05/28/", 
        "1996/05/29/", 
        "1996/05/30/", 
        "1996/05/31/"
    ]
}
