{
    "Keys": [
        {
            "ETag": "\"d41d8cd98f00b204e9800998ecf8427e\"", 
            "Key": "2005/08/", 
            "Size": 0
        }
    ], 
    "CommonPrefixes": [
        "2005/08/01/", 
        "2005/08/02/", 
        "2005/08/03/", 
        "2005/08/04/", 
        "2005/08/05/", 
        "2005/08/06/", 
        "2005/08/07/", 
        "2005/08/08/", 
        "2005/08/09/", 
        "2005/08/10/", 
        "2005/08/11/", 
        "2005/08/12/", 
        "2005/08/13/", 
        "2005/08/14/", 
        "2005/08/15/", 
        "2005/08/16/", 
        "2005/08/17/", 
        "2005/08/18/", 
        "2005/08/19/", 
        "2005/08/20/", 
        "2005/08/21/", 
        "2005/08/22/", 
        "2005/08/23/", 
        "2005/08/24/", 
        "2005/08/25/", 
        "2005/08/26/", 
        "2005/08/27/", 
        "2005/08/28/", 
        "2005/08/29/", 
        "2005/08/30/", 
        "2005/08/31/"
    ]
}
