{
    "Keys": [
        {
            "ETag": "\"d41d8cd98f00b204e9800998ecf8427e\"", 
            "Key": "2006/11/", 
            "Size": 0
        }
    ], 
    "CommonPrefixes": [
        "2006/11/01/", 
        "2006/11/02/", 
        "2006/11/03/", 
        "2006/11/04/", 
        "2006/11/05/", 
        "2006/11/06/", 
        "2006/11/07/", 
        "2006/11/08/", 
        "2006/11/09/", 
        "2006/11/10/", 
        "2006/11/11/", 
        "2006/11/12/", 
        "2006/11/13/", 
        "2006/11/14/", 
        "2006/11/15/", 
        "2006/11/16/", 
        "2006/11/17/", 
        "2006/11/18/", 
        "2006/11/19/", 
        "2006/11/20/", 
        "2006/11/21/", 
        "2006/11/22/", 
        "2006/11/23/", 
        "2006/11/24/", 
        "2006/11/25/", 
        "2006/11/26/", 
        "2006/11/27/", 
        "2006/11/28/", 
        "2006/11/29/", 
        "2006/11/30/"
    ]
}
