{
    "Keys": null, 
    "CommonPrefixes": [
        "2010/05/01/", 
        "2010/05/02/", 
        "2010/05/03/", 
        "2010/05/04/", 
        "2010/05/05/", 
        "2010/05/06/", 
        "2010/05/07/", 
        "2010/05/08/", 
        "2010/05/09/", 
        "2010/05/10/", 
        "2010/05/11/", 
        "2010/05/12/", 
        "2010/05/13/", 
        "2010/05/14/", 
        "2010/05/15/", 
        "2010/05/16/", 
        "2010/05/17/", 
        "2010/05/18/", 
        "2010/05/19/", 
        "2010/05/20/", 
        "2010/05/21/", 
        "2010/05/22/", 
        "2010/05/23/", 
        "2010/05/24/", 
        "2010/05/25/", 
        "2010/05/26/", 
        "2010/05/27/", 
        "2010/05/28/", 
        "2010/05/29/", 
        "2010/05/30/", 
        "2010/05/31/"
    ]
}
