{
    "Keys": [
        {
            "ETag": "\"d41d8cd98f00b204e9800998ecf8427e\"", 
            "Key": "2000/08/", 
            "Size": 0
        }
    ], 
    "CommonPrefixes": [
        "2000/08/01/", 
        "2000/08/02/", 
        "2000/08/03/", 
        "2000/08/04/", 
        "2000/08/05/", 
        "2000/08/06/", 
        "2000/08/07/", 
        "2000/08/08/", 
        "2000/08/09/", 
        "2000/08/10/", 
        "2000/08/11/", 
        "2000/08/12/", 
        "2000/08/13/", 
        "2000/08/14/", 
        "2000/08/15/", 
        "2000/08/16/", 
        "2000/08/17/", 
        "2000/08/18/", 
        "2000/08/19/", 
        "2000/08/20/", 
        "2000/08/21/", 
        "2000/08/22/", 
        "2000/08/23/", 
        "2000/08/24/", 
        "2000/08/25/", 
        "2000/08/26/", 
        "2000/08/27/", 
        "2000/08/28/", 
        "2000/08/29/", 
        "2000/08/30/", 
        "2000/08/31/"
    ]
}
