{
    "Keys": [
        {
            "ETag": "\"d41d8cd98f00b204e9800998ecf8427e\"", 
            "Key": "2007/07/", 
            "Size": 0
        }
    ], 
    "CommonPrefixes": [
        "2007/07/01/", 
        "2007/07/02/", 
        "2007/07/03/", 
        "2007/07/04/", 
        "2007/07/05/", 
        "2007/07/06/", 
        "2007/07/07/", 
        "2007/07/08/", 
        "2007/07/09/", 
        "2007/07/10/", 
        "2007/07/11/", 
        "2007/07/12/", 
        "2007/07/13/", 
        "2007/07/14/", 
        "2007/07/15/", 
        "2007/07/16/", 
        "2007/07/17/", 
        "2007/07/18/", 
        "2007/07/19/", 
        "2007/07/20/", 
        "2007/07/21/", 
        "2007/07/22/", 
        "2007/07/23/", 
        "2007/07/24/", 
        "2007/07/25/", 
        "2007/07/26/", 
        "2007/07/27/", 
        "2007/07/28/", 
        "2007/07/29/", 
        "2007/07/30/", 
        "2007/07/31/"
    ]
}
