{
    "Keys": null, 
    "CommonPrefixes": [
        "2017/07/01/", 
        "2017/07/02/", 
        "2017/07/03/", 
        "2017/07/04/", 
        "2017/07/05/", 
        "2017/07/06/", 
        "2017/07/07/", 
        "2017/07/08/", 
        "2017/07/09/", 
        "2017/07/10/", 
        "2017/07/11/", 
        "2017/07/12/", 
        "2017/07/13/", 
        "2017/07/14/", 
        "2017/07/15/", 
        "2017/07/16/", 
        "2017/07/17/", 
        "2017/07/18/", 
        "2017/07/19/", 
        "2017/07/20/", 
        "2017/07/21/", 
        "2017/07/22/", 
        "2017/07/23/", 
        "2017/07/24/", 
        "2017/07/25/", 
        "2017/07/26/", 
        "2017/07/27/", 
        "2017/07/28/", 
        "2017/07/29/", 
        "2017/07/30/", 
        "2017/07/31/"
    ]
}
