{
    "Keys": [
        {
            "ETag": "\"d41d8cd98f00b204e9800998ecf8427e\"", 
            "Key": "2003/05/", 
            "Size": 0
        }
    ], 
    "CommonPrefixes": [
        "2003/05/01/", 
        "2003/05/02/", 
        "2003/05/03/", 
        "2003/05/04/", 
        "2003/05/05/", 
        "2003/05/06/", 
        "2003/05/07/", 
        "2003/05/08/", 
        "2003/05/09/", 
        "2003/05/10/", 
        "2003/05/11/", 
        "2003/05/12/", 
        "2003/05/13/", 
        "2003/05/14/", 
        "2003/05/15/", 
        "2003/05/16/", 
        "2003/05/17/", 
        "2003/05/18/", 
        "2003/05/19/", 
        "2003/05/20/", 
        "2003/05/21/", 
        "2003/05/22/", 
        "2003/05/23/", 
        "2003/05/24/", 
        "2003/05/25/", 
        "2003/05/26/", 
        "2003/05/27/", 
        "2003/05/28/", 
        "2003/05/29/", 
        "2003/05/30/", 
        "2003/05/31/"
    ]
}
