{
    "Keys": [
        {
            "ETag": "\"d41d8cd98f00b204e9800998ecf8427e\"", 
            "Key": "1995/12/", 
            "Size": 0
        }
    ], 
    "CommonPrefixes": [
        "1995/12/01/", 
        "1995/12/02/", 
        "1995/12/03/", 
        "1995/12/04/", 
        "1995/12/05/", 
        "1995/12/06/", 
        "1995/12/07/", 
        "1995/12/08/", 
        "1995/12/09/", 
        "1995/12/10/", 
        "1995/12/11/", 
        "1995/12/12/", 
        "1995/12/13/", 
        "1995/12/14/", 
        "1995/12/15/", 
        "1995/12/16/", 
        "1995/12/17/", 
        "1995/12/18/", 
        "1995/12/19/", 
        "1995/12/20/", 
        "1995/12/21/", 
        "1995/12/22/", 
        "1995/12/23/", 
        "1995/12/24/", 
        "1995/12/25/", 
        "1995/12/26/", 
        "1995/12/27/", 
        "1995/12/28/", 
        "1995/12/29/", 
        "1995/12/30/", 
        "1995/12/31/"
    ]
}
