{
    "Keys": null, 
    "CommonPrefixes": [
        "2011/04/01/", 
        "2011/04/02/", 
        "2011/04/03/", 
        "2011/04/04/", 
        "2011/04/05/", 
        "2011/04/06/", 
        "2011/04/07/", 
        "2011/04/08/", 
        "2011/04/09/", 
        "2011/04/10/", 
        "2011/04/11/", 
        "2011/04/12/", 
        "2011/04/13/", 
        "2011/04/14/", 
        "2011/04/15/", 
        "2011/04/16/", 
        "2011/04/17/", 
        "2011/04/18/", 
        "2011/04/19/", 
        "2011/04/20/", 
        "2011/04/21/", 
        "2011/04/22/", 
        "2011/04/23/", 
        "2011/04/24/", 
        "2011/04/25/", 
        "2011/04/26/", 
        "2011/04/27/", 
        "2011/04/28/", 
        "2011/04/29/", 
        "2011/04/30/"
    ]
}
