{
    "Keys": [
        {
            "ETag": "\"d41d8cd98f00b204e9800998ecf8427e\"", 
            "Key": "2003/06/", 
            "Size": 0
        }
    ], 
    "CommonPrefixes": [
        "2003/06/02/", 
        "2003/06/05/", 
        "2003/06/07/", 
        "2003/06/08/", 
        "2003/06/09/", 
        "2003/06/10/", 
        "2003/06/13/", 
        "2003/06/14/", 
        "2003/06/15/", 
        "2003/06/17/", 
        "2003/06/18/", 
        "2003/06/19/", 
        "2003/06/22/", 
        "2003/06/25/", 
        "2003/06/27/", 
        "2003/06/29/", 
        "2003/06/30/"
    ]
}
