{
    "Keys": [
        {
            "ETag": "\"d41d8cd98f00b204e9800998ecf8427e\"", 
            "Key": "2008/03/", 
            "Size": 0
        }
    ], 
    "CommonPrefixes": [
        "2008/03/01/", 
        "2008/03/02/", 
        "2008/03/03/", 
        "2008/03/04/", 
        "2008/03/05/", 
        "2008/03/06/", 
        "2008/03/07/", 
        "2008/03/08/", 
        "2008/03/09/", 
        "2008/03/10/", 
        "2008/03/11/", 
        "2008/03/12/", 
        "2008/03/13/", 
        "2008/03/14/", 
        "2008/03/15/", 
        "2008/03/16/", 
        "2008/03/17/", 
        "2008/03/18/", 
        "2008/03/19/", 
        "2008/03/20/", 
        "2008/03/21/", 
        "2008/03/22/", 
        "2008/03/23/", 
        "2008/03/24/", 
        "2008/03/25/", 
        "2008/03/26/", 
        "2008/03/27/", 
        "2008/03/28/", 
        "2008/03/29/", 
        "2008/03/30/", 
        "2008/03/31/"
    ]
}
