{
    "Keys": [
        {
            "ETag": "\"d41d8cd98f00b204e9800998ecf8427e\"", 
            "Key": "2012/01/", 
            "Size": 0
        }
    ], 
    "CommonPrefixes": [
        "2012/01/01/", 
        "2012/01/02/", 
        "2012/01/03/", 
        "2012/01/04/", 
        "2012/01/05/", 
        "2012/01/06/", 
        "2012/01/07/", 
        "2012/01/08/", 
        "2012/01/09/", 
        "2012/01/10/", 
        "2012/01/11/", 
        "2012/01/12/", 
        "2012/01/13/", 
        "2012/01/14/", 
        "2012/01/15/", 
        "2012/01/16/", 
        "2012/01/17/", 
        "2012/01/18/", 
        "2012/01/19/", 
        "2012/01/20/", 
        "2012/01/21/", 
        "2012/01/22/", 
        "2012/01/23/", 
        "2012/01/24/", 
        "2012/01/25/", 
        "2012/01/26/", 
        "2012/01/27/", 
        "2012/01/28/", 
        "2012/01/29/", 
        "2012/01/30/", 
        "2012/01/31/"
    ]
}
