{
    "Keys": [
        {
            "ETag": "\"d41d8cd98f00b204e9800998ecf8427e\"", 
            "Key": "2003/10/", 
            "Size": 0
        }
    ], 
    "CommonPrefixes": [
        "2003/10/01/", 
        "2003/10/02/", 
        "2003/10/03/", 
        "2003/10/04/", 
        "2003/10/05/", 
        "2003/10/06/", 
        "2003/10/07/", 
        "2003/10/08/", 
        "2003/10/09/", 
        "2003/10/10/", 
        "2003/10/11/", 
        "2003/10/12/", 
        "2003/10/13/", 
        "2003/10/14/", 
        "2003/10/15/", 
        "2003/10/16/", 
        "2003/10/17/", 
        "2003/10/18/", 
        "2003/10/19/", 
        "2003/10/20/", 
        "2003/10/21/", 
        "2003/10/22/", 
        "2003/10/23/", 
        "2003/10/24/", 
        "2003/10/25/", 
        "2003/10/26/", 
        "2003/10/27/", 
        "2003/10/28/", 
        "2003/10/29/", 
        "2003/10/30/", 
        "2003/10/31/"
    ]
}
