{
    "Keys": null, 
    "CommonPrefixes": [
        "2016/11/01/", 
        "2016/11/02/", 
        "2016/11/03/", 
        "2016/11/04/", 
        "2016/11/05/", 
        "2016/11/06/", 
        "2016/11/07/", 
        "2016/11/08/", 
        "2016/11/09/", 
        "2016/11/10/", 
        "2016/11/11/", 
        "2016/11/12/", 
        "2016/11/13/", 
        "2016/11/14/", 
        "2016/11/15/", 
        "2016/11/16/", 
        "2016/11/17/", 
        "2016/11/18/", 
        "2016/11/19/", 
        "2016/11/20/", 
        "2016/11/21/", 
        "2016/11/22/", 
        "2016/11/23/", 
        "2016/11/24/", 
        "2016/11/25/", 
        "2016/11/26/", 
        "2016/11/27/", 
        "2016/11/28/", 
        "2016/11/29/", 
        "2016/11/30/"
    ]
}
