{
    "Keys": [
        {
            "ETag": "\"d41d8cd98f00b204e9800998ecf8427e\"", 
            "Key": "2007/11/", 
            "Size": 0
        }
    ], 
    "CommonPrefixes": [
        "2007/11/01/", 
        "2007/11/02/", 
        "2007/11/03/", 
        "2007/11/04/", 
        "2007/11/05/", 
        "2007/11/06/", 
        "2007/11/07/", 
        "2007/11/08/", 
        "2007/11/09/", 
        "2007/11/10/", 
        "2007/11/11/", 
        "2007/11/12/", 
        "2007/11/13/", 
        "2007/11/14/", 
        "2007/11/15/", 
        "2007/11/16/", 
        "2007/11/17/", 
        "2007/11/18/", 
        "2007/11/19/", 
        "2007/11/20/", 
        "2007/11/21/", 
        "2007/11/22/", 
        "2007/11/23/", 
        "2007/11/24/", 
        "2007/11/25/", 
        "2007/11/26/", 
        "2007/11/27/", 
        "2007/11/28/", 
        "2007/11/29/", 
        "2007/11/30/"
    ]
}
