{
    "Keys": [
        {
            "ETag": "\"d41d8cd98f00b204e9800998ecf8427e\"", 
            "Key": "2004/03/", 
            "Size": 0
        }
    ], 
    "CommonPrefixes": [
        "2004/03/01/", 
        "2004/03/02/", 
        "2004/03/03/", 
        "2004/03/04/", 
        "2004/03/05/", 
        "2004/03/06/", 
        "2004/03/07/", 
        "2004/03/08/", 
        "2004/03/09/", 
        "2004/03/10/", 
        "2004/03/11/", 
        "2004/03/12/", 
        "2004/03/13/", 
        "2004/03/14/", 
        "2004/03/15/", 
        "2004/03/16/", 
        "2004/03/17/", 
        "2004/03/18/", 
        "2004/03/19/", 
        "2004/03/20/", 
        "2004/03/21/", 
        "2004/03/22/", 
        "2004/03/23/", 
        "2004/03/24/", 
        "2004/03/25/", 
        "2004/03/26/", 
        "2004/03/27/", 
        "2004/03/28/", 
        "2004/03/29/", 
        "2004/03/30/", 
        "2004/03/31/"
    ]
}
