{
    "Keys": [
        {
            "ETag": "\"d41d8cd98f00b204e9800998ecf8427e\"", 
            "Key": "1997/02/", 
            "Size": 0
        }
    ], 
    "CommonPrefixes": [
        "1997/02/01/", 
        "1997/02/02/", 
        "1997/02/03/", 
        "1997/02/04/", 
        "1997/02/05/", 
        "1997/02/06/", 
        "1997/02/07/", 
        "1997/02/08/", 
        "1997/02/09/", 
        "1997/02/10/", 
        "1997/02/11/", 
        "1997/02/12/", 
        "1997/02/13/", 
        "1997/02/14/", 
        "1997/02/15/", 
        "1997/02/16/", 
        "1997/02/17/", 
        "1997/02/18/", 
        "1997/02/19/", 
        "1997/02/20/", 
        "1997/02/21/", 
        "1997/02/22/", 
        "1997/02/23/", 
        "1997/02/24/", 
        "1997/02/25/", 
        "1997/02/26/", 
        "1997/02/27/", 
        "1997/02/28/"
    ]
}
