{
    "Keys": [
        {
            "ETag": "\"d41d8cd98f00b204e9800998ecf8427e\"", 
            "Key": "1995/06/", 
            "Size": 0
        }
    ], 
    "CommonPrefixes": [
        "1995/06/01/", 
        "1995/06/02/", 
        "1995/06/03/", 
        "1995/06/04/", 
        "1995/06/05/", 
        "1995/06/06/", 
        "1995/06/07/", 
        "1995/06/08/", 
        "1995/06/09/", 
        "1995/06/10/", 
        "1995/06/11/", 
        "1995/06/12/", 
        "1995/06/13/", 
        "1995/06/14/", 
        "1995/06/15/", 
        "1995/06/16/", 
        "1995/06/17/", 
        "1995/06/18/", 
        "1995/06/19/", 
        "1995/06/20/", 
        "1995/06/21/", 
        "1995/06/22/", 
        "1995/06/23/", 
        "1995/06/24/", 
        "1995/06/25/", 
        "1995/06/26/", 
        "1995/06/27/", 
        "1995/06/28/", 
        "1995/06/29/", 
        "1995/06/30/"
    ]
}
