{
    "Keys": [
        {
            "ETag": "\"d41d8cd98f00b204e9800998ecf8427e\"", 
            "Key": "1993/09/", 
            "Size": 0
        }
    ], 
    "CommonPrefixes": [
        "1993/09/01/", 
        "1993/09/02/", 
        "1993/09/03/", 
        "1993/09/04/", 
        "1993/09/05/", 
        "1993/09/06/", 
        "1993/09/07/", 
        "1993/09/08/", 
        "1993/09/09/", 
        "1993/09/10/", 
        "1993/09/11/", 
        "1993/09/12/", 
        "1993/09/13/", 
        "1993/09/14/", 
        "1993/09/15/", 
        "1993/09/16/", 
        "1993/09/17/", 
        "1993/09/18/", 
        "1993/09/19/", 
        "1993/09/20/", 
        "1993/09/21/", 
        "1993/09/22/", 
        "1993/09/23/", 
        "1993/09/24/", 
        "1993/09/25/", 
        "1993/09/26/", 
        "1993/09/27/", 
        "1993/09/28/", 
        "1993/09/29/", 
        "1993/09/30/"
    ]
}
