{
    "Keys": [
        {
            "ETag": "\"d41d8cd98f00b204e9800998ecf8427e\"", 
            "Key": "2005/07/", 
            "Size": 0
        }
    ], 
    "CommonPrefixes": [
        "2005/07/01/", 
        "2005/07/02/", 
        "2005/07/03/", 
        "2005/07/04/", 
        "2005/07/05/", 
        "2005/07/06/", 
        "2005/07/07/", 
        "2005/07/08/", 
        "2005/07/09/", 
        "2005/07/10/", 
        "2005/07/11/", 
        "2005/07/12/", 
        "2005/07/13/", 
        "2005/07/14/", 
        "2005/07/15/", 
        "2005/07/16/", 
        "2005/07/17/", 
        "2005/07/18/", 
        "2005/07/19/", 
        "2005/07/20/", 
        "2005/07/21/", 
        "2005/07/22/", 
        "2005/07/23/", 
        "2005/07/24/", 
        "2005/07/25/", 
        "2005/07/26/", 
        "2005/07/27/", 
        "2005/07/28/", 
        "2005/07/29/", 
        "2005/07/30/", 
        "2005/07/31/"
    ]
}
