{
    "Keys": null, 
    "CommonPrefixes": [
        "2016/09/01/", 
        "2016/09/02/", 
        "2016/09/03/", 
        "2016/09/04/", 
        "2016/09/05/", 
        "2016/09/06/", 
        "2016/09/07/", 
        "2016/09/08/", 
        "2016/09/09/", 
        "2016/09/10/", 
        "2016/09/11/", 
        "2016/09/12/", 
        "2016/09/13/", 
        "2016/09/14/", 
        "2016/09/15/", 
        "2016/09/16/", 
        "2016/09/17/", 
        "2016/09/18/", 
        "2016/09/19/", 
        "2016/09/20/", 
        "2016/09/21/", 
        "2016/09/22/", 
        "2016/09/23/", 
        "2016/09/24/", 
        "2016/09/25/", 
        "2016/09/26/", 
        "2016/09/27/", 
        "2016/09/28/", 
        "2016/09/29/", 
        "2016/09/30/"
    ]
}
