{
    "Keys": [
        {
            "ETag": "\"d41d8cd98f00b204e9800998ecf8427e\"", 
            "Key": "2005/12/", 
            "Size": 0
        }
    ], 
    "CommonPrefixes": [
        "2005/12/01/", 
        "2005/12/02/", 
        "2005/12/03/", 
        "2005/12/04/", 
        "2005/12/05/", 
        "2005/12/06/", 
        "2005/12/07/", 
        "2005/12/08/", 
        "2005/12/09/", 
        "2005/12/10/", 
        "2005/12/11/", 
        "2005/12/12/", 
        "2005/12/13/", 
        "2005/12/14/", 
        "2005/12/15/", 
        "2005/12/16/", 
        "2005/12/17/", 
        "2005/12/18/", 
        "2005/12/19/", 
        "2005/12/20/", 
        "2005/12/21/", 
        "2005/12/22/", 
        "2005/12/23/", 
        "2005/12/24/", 
        "2005/12/25/", 
        "2005/12/26/", 
        "2005/12/27/", 
        "2005/12/28/", 
        "2005/12/29/", 
        "2005/12/30/", 
        "2005/12/31/"
    ]
}
