{
    "Keys": [
        {
            "ETag": "\"d41d8cd98f00b204e9800998ecf8427e\"", 
            "Key": "2009/03/", 
            "Size": 0
        }
    ], 
    "CommonPrefixes": [
        "2009/03/01/", 
        "2009/03/02/", 
        "2009/03/03/", 
        "2009/03/04/", 
        "2009/03/05/", 
        "2009/03/06/", 
        "2009/03/07/", 
        "2009/03/08/", 
        "2009/03/09/", 
        "2009/03/10/", 
        "2009/03/11/", 
        "2009/03/12/", 
        "2009/03/13/", 
        "2009/03/14/", 
        "2009/03/15/", 
        "2009/03/16/", 
        "2009/03/17/", 
        "2009/03/18/", 
        "2009/03/19/", 
        "2009/03/20/", 
        "2009/03/21/", 
        "2009/03/22/", 
        "2009/03/23/", 
        "2009/03/24/", 
        "2009/03/25/", 
        "2009/03/26/", 
        "2009/03/27/", 
        "2009/03/28/", 
        "2009/03/29/", 
        "2009/03/30/", 
        "2009/03/31/"
    ]
}
