{
    "Keys": [
        {
            "ETag": "\"d41d8cd98f00b204e9800998ecf8427e\"", 
            "Key": "2008/05/", 
            "Size": 0
        }
    ], 
    "CommonPrefixes": [
        "2008/05/01/", 
        "2008/05/02/", 
        "2008/05/03/", 
        "2008/05/04/", 
        "2008/05/05/", 
        "2008/05/06/", 
        "2008/05/07/", 
        "2008/05/08/", 
        "2008/05/09/", 
        "2008/05/10/", 
        "2008/05/11/", 
        "2008/05/12/", 
        "2008/05/13/", 
        "2008/05/14/", 
        "2008/05/15/", 
        "2008/05/16/", 
        "2008/05/17/", 
        "2008/05/18/", 
        "2008/05/19/", 
        "2008/05/20/", 
        "2008/05/21/", 
        "2008/05/22/", 
        "2008/05/23/", 
        "2008/05/24/", 
        "2008/05/25/", 
        "2008/05/26/", 
        "2008/05/27/", 
        "2008/05/28/", 
        "2008/05/29/", 
        "2008/05/30/", 
        "2008/05/31/"
    ]
}
