{
    "Keys": [
        {
            "ETag": "\"d41d8cd98f00b204e9800998ecf8427e\"", 
            "Key": "1997/06/", 
            "Size": 0
        }
    ], 
    "CommonPrefixes": [
        "1997/06/01/", 
        "1997/06/02/", 
        "1997/06/03/", 
        "1997/06/04/", 
        "1997/06/05/", 
        "1997/06/06/", 
        "1997/06/07/", 
        "1997/06/08/", 
        "1997/06/09/", 
        "1997/06/10/", 
        "1997/06/11/", 
        "1997/06/12/", 
        "1997/06/13/", 
        "1997/06/14/", 
        "1997/06/15/", 
        "1997/06/16/", 
        "1997/06/17/", 
        "1997/06/18/", 
        "1997/06/19/", 
        "1997/06/20/", 
        "1997/06/21/", 
        "1997/06/22/", 
        "1997/06/23/", 
        "1997/06/24/", 
        "1997/06/25/", 
        "1997/06/26/", 
        "1997/06/27/", 
        "1997/06/28/", 
        "1997/06/29/", 
        "1997/06/30/"
    ]
}
