{
    "Keys": [
        {
            "ETag": "\"d41d8cd98f00b204e9800998ecf8427e\"", 
            "Key": "1992/05/", 
            "Size": 0
        }
    ], 
    "CommonPrefixes": [
        "1992/05/01/", 
        "1992/05/02/", 
        "1992/05/03/", 
        "1992/05/04/", 
        "1992/05/05/", 
        "1992/05/06/", 
        "1992/05/07/", 
        "1992/05/08/", 
        "1992/05/09/", 
        "1992/05/10/", 
        "1992/05/11/", 
        "1992/05/12/", 
        "1992/05/13/", 
        "1992/05/14/", 
        "1992/05/15/", 
        "1992/05/16/", 
        "1992/05/17/", 
        "1992/05/22/", 
        "1992/05/23/", 
        "1992/05/24/", 
        "1992/05/25/", 
        "1992/05/26/", 
        "1992/05/27/", 
        "1992/05/28/", 
        "1992/05/29/", 
        "1992/05/30/", 
        "1992/05/31/"
    ]
}
