{
    "Keys": [
        {
            "ETag": "\"d41d8cd98f00b204e9800998ecf8427e\"", 
            "Key": "2007/06/", 
            "Size": 0
        }
    ], 
    "CommonPrefixes": [
        "2007/06/01/", 
        "2007/06/02/", 
        "2007/06/03/", 
        "2007/06/04/", 
        "2007/06/05/", 
        "2007/06/06/", 
        "2007/06/07/", 
        "2007/06/08/", 
        "2007/06/09/", 
        "2007/06/10/", 
        "2007/06/11/", 
        "2007/06/12/", 
        "2007/06/13/", 
        "2007/06/14/", 
        "2007/06/15/", 
        "2007/06/16/", 
        "2007/06/17/", 
        "2007/06/18/", 
        "2007/06/19/", 
        "2007/06/20/", 
        "2007/06/21/", 
        "2007/06/22/", 
        "2007/06/23/", 
        "2007/06/24/", 
        "2007/06/25/", 
        "2007/06/26/", 
        "2007/06/27/", 
        "2007/06/28/", 
        "2007/06/29/", 
        "2007/06/30/"
    ]
}
