{
    "Keys": [
        {
            "ETag": "\"d41d8cd98f00b204e9800998ecf8427e\"", 
            "Key": "2008/12/", 
            "Size": 0
        }
    ], 
    "CommonPrefixes": [
        "2008/12/01/", 
        "2008/12/02/", 
        "2008/12/03/", 
        "2008/12/04/", 
        "2008/12/05/", 
        "2008/12/06/", 
        "2008/12/07/", 
        "2008/12/08/", 
        "2008/12/09/", 
        "2008/12/10/", 
        "2008/12/11/", 
        "2008/12/12/", 
        "2008/12/13/", 
        "2008/12/14/", 
        "2008/12/15/", 
        "2008/12/16/", 
        "2008/12/17/", 
        "2008/12/18/", 
        "2008/12/19/", 
        "2008/12/20/", 
        "2008/12/21/", 
        "2008/12/22/", 
        "2008/12/23/", 
        "2008/12/24/", 
        "2008/12/25/", 
        "2008/12/26/", 
        "2008/12/27/", 
        "2008/12/28/", 
        "2008/12/29/", 
        "2008/12/30/", 
        "2008/12/31/"
    ]
}
