{
    "Keys": [
        {
            "ETag": "\"d41d8cd98f00b204e9800998ecf8427e\"", 
            "Key": "2005/06/", 
            "Size": 0
        }
    ], 
    "CommonPrefixes": [
        "2005/06/01/", 
        "2005/06/02/", 
        "2005/06/03/", 
        "2005/06/04/", 
        "2005/06/05/", 
        "2005/06/06/", 
        "2005/06/07/", 
        "2005/06/08/", 
        "2005/06/09/", 
        "2005/06/10/", 
        "2005/06/11/", 
        "2005/06/12/", 
        "2005/06/13/", 
        "2005/06/14/", 
        "2005/06/15/", 
        "2005/06/16/", 
        "2005/06/17/", 
        "2005/06/18/", 
        "2005/06/19/", 
        "2005/06/20/", 
        "2005/06/21/", 
        "2005/06/22/", 
        "2005/06/23/", 
        "2005/06/24/", 
        "2005/06/25/", 
        "2005/06/26/", 
        "2005/06/27/", 
        "2005/06/28/", 
        "2005/06/29/", 
        "2005/06/30/"
    ]
}
