{
    "Keys": null, 
    "CommonPrefixes": [
        "2014/02/01/", 
        "2014/02/02/", 
        "2014/02/03/", 
        "2014/02/04/", 
        "2014/02/05/", 
        "2014/02/06/", 
        "2014/02/07/", 
        "2014/02/08/", 
        "2014/02/09/", 
        "2014/02/10/", 
        "2014/02/11/", 
        "2014/02/12/", 
        "2014/02/13/", 
        "2014/02/14/", 
        "2014/02/15/", 
        "2014/02/16/", 
        "2014/02/17/", 
        "2014/02/18/", 
        "2014/02/19/", 
        "2014/02/20/", 
        "2014/02/21/", 
        "2014/02/22/", 
        "2014/02/23/", 
        "2014/02/24/", 
        "2014/02/25/", 
        "2014/02/26/", 
        "2014/02/27/", 
        "2014/02/28/"
    ]
}
