{
    "Keys": [
        {
            "ETag": "\"d41d8cd98f00b204e9800998ecf8427e\"", 
            "Key": "2003/11/", 
            "Size": 0
        }
    ], 
    "CommonPrefixes": [
        "2003/11/01/", 
        "2003/11/02/", 
        "2003/11/03/", 
        "2003/11/04/", 
        "2003/11/05/", 
        "2003/11/06/", 
        "2003/11/07/", 
        "2003/11/08/", 
        "2003/11/09/", 
        "2003/11/10/", 
        "2003/11/11/", 
        "2003/11/12/", 
        "2003/11/13/", 
        "2003/11/14/", 
        "2003/11/15/", 
        "2003/11/16/", 
        "2003/11/17/", 
        "2003/11/18/", 
        "2003/11/19/", 
        "2003/11/20/", 
        "2003/11/21/", 
        "2003/11/22/", 
        "2003/11/23/", 
        "2003/11/24/", 
        "2003/11/25/", 
        "2003/11/26/", 
        "2003/11/27/", 
        "2003/11/28/", 
        "2003/11/29/", 
        "2003/11/30/"
    ]
}
