{
    "Keys": [
        {
            "ETag": "\"d41d8cd98f00b204e9800998ecf8427e\"", 
            "Key": "2008/07/", 
            "Size": 0
        }
    ], 
    "CommonPrefixes": [
        "2008/07/01/", 
        "2008/07/02/", 
        "2008/07/03/", 
        "2008/07/04/", 
        "2008/07/05/", 
        "2008/07/06/", 
        "2008/07/07/", 
        "2008/07/08/", 
        "2008/07/09/", 
        "2008/07/10/", 
        "2008/07/11/", 
        "2008/07/12/", 
        "2008/07/13/", 
        "2008/07/14/", 
        "2008/07/15/", 
        "2008/07/16/", 
        "2008/07/17/", 
        "2008/07/18/", 
        "2008/07/19/", 
        "2008/07/20/", 
        "2008/07/21/", 
        "2008/07/22/", 
        "2008/07/23/", 
        "2008/07/24/", 
        "2008/07/25/", 
        "2008/07/26/", 
        "2008/07/27/", 
        "2008/07/28/", 
        "2008/07/29/", 
        "2008/07/30/", 
        "2008/07/31/"
    ]
}
