{
    "Keys": null, 
    "CommonPrefixes": [
        "2010/06/01/", 
        "2010/06/02/", 
        "2010/06/03/", 
        "2010/06/04/", 
        "2010/06/05/", 
        "2010/06/06/", 
        "2010/06/07/", 
        "2010/06/08/", 
        "2010/06/09/", 
        "2010/06/10/", 
        "2010/06/11/", 
        "2010/06/12/", 
        "2010/06/13/", 
        "2010/06/14/", 
        "2010/06/15/", 
        "2010/06/16/", 
        "2010/06/17/", 
        "2010/06/18/", 
        "2010/06/19/", 
        "2010/06/20/", 
        "2010/06/21/", 
        "2010/06/22/", 
        "2010/06/23/", 
        "2010/06/24/", 
        "2010/06/25/", 
        "2010/06/26/", 
        "2010/06/27/", 
        "2010/06/28/", 
        "2010/06/29/", 
        "2010/06/30/"
    ]
}
