{
    "Keys": [
        {
            "ETag": "\"d41d8cd98f00b204e9800998ecf8427e\"", 
            "Key": "1999/05/", 
            "Size": 0
        }
    ], 
    "CommonPrefixes": [
        "1999/05/01/", 
        "1999/05/02/", 
        "1999/05/03/", 
        "1999/05/04/", 
        "1999/05/05/", 
        "1999/05/06/", 
        "1999/05/07/", 
        "1999/05/08/", 
        "1999/05/09/", 
        "1999/05/10/", 
        "1999/05/11/", 
        "1999/05/12/", 
        "1999/05/13/", 
        "1999/05/14/", 
        "1999/05/15/", 
        "1999/05/16/", 
        "1999/05/17/", 
        "1999/05/18/", 
        "1999/05/19/", 
        "1999/05/20/", 
        "1999/05/21/", 
        "1999/05/22/", 
        "1999/05/23/", 
        "1999/05/24/", 
        "1999/05/25/", 
        "1999/05/26/", 
        "1999/05/27/", 
        "1999/05/28/", 
        "1999/05/29/", 
        "1999/05/30/", 
        "1999/05/31/"
    ]
}
