{
    "Keys": null, 
    "CommonPrefixes": [
        "2011/10/01/", 
        "2011/10/02/", 
        "2011/10/03/", 
        "2011/10/04/", 
        "2011/10/05/", 
        "2011/10/06/", 
        "2011/10/07/", 
        "2011/10/08/", 
        "2011/10/09/", 
        "2011/10/10/", 
        "2011/10/11/", 
        "2011/10/12/", 
        "2011/10/13/", 
        "2011/10/14/", 
        "2011/10/15/", 
        "2011/10/16/", 
        "2011/10/17/", 
        "2011/10/18/", 
        "2011/10/19/", 
        "2011/10/20/", 
        "2011/10/21/", 
        "2011/10/22/", 
        "2011/10/23/", 
        "2011/10/24/", 
        "2011/10/25/", 
        "2011/10/26/", 
        "2011/10/27/", 
        "2011/10/28/", 
        "2011/10/29/", 
        "2011/10/30/", 
        "2011/10/31/"
    ]
}
