{
    "Keys": [
        {
            "ETag": "\"d41d8cd98f00b204e9800998ecf8427e\"", 
            "Key": "2006/12/", 
            "Size": 0
        }
    ], 
    "CommonPrefixes": [
        "2006/12/01/", 
        "2006/12/02/", 
        "2006/12/03/", 
        "2006/12/04/", 
        "2006/12/05/", 
        "2006/12/06/", 
        "2006/12/07/", 
        "2006/12/08/", 
        "2006/12/09/", 
        "2006/12/10/", 
        "2006/12/11/", 
        "2006/12/12/", 
        "2006/12/13/", 
        "2006/12/14/", 
        "2006/12/15/", 
        "2006/12/16/", 
        "2006/12/17/", 
        "2006/12/18/", 
        "2006/12/19/", 
        "2006/12/20/", 
        "2006/12/21/", 
        "2006/12/22/", 
        "2006/12/23/", 
        "2006/12/24/", 
        "2006/12/25/", 
        "2006/12/26/", 
        "2006/12/27/", 
        "2006/12/28/", 
        "2006/12/29/", 
        "2006/12/30/", 
        "2006/12/31/"
    ]
}
