{
    "Keys": [
        {
            "ETag": "\"d41d8cd98f00b204e9800998ecf8427e\"", 
            "Key": "2000/05/", 
            "Size": 0
        }
    ], 
    "CommonPrefixes": [
        "2000/05/01/", 
        "2000/05/02/", 
        "2000/05/03/", 
        "2000/05/04/", 
        "2000/05/05/", 
        "2000/05/06/", 
        "2000/05/07/", 
        "2000/05/08/", 
        "2000/05/09/", 
        "2000/05/10/", 
        "2000/05/11/", 
        "2000/05/12/", 
        "2000/05/13/", 
        "2000/05/14/", 
        "2000/05/15/", 
        "2000/05/16/", 
        "2000/05/17/", 
        "2000/05/18/", 
        "2000/05/19/", 
        "2000/05/20/", 
        "2000/05/21/", 
        "2000/05/22/", 
        "2000/05/23/", 
        "2000/05/24/", 
        "2000/05/25/", 
        "2000/05/26/", 
        "2000/05/27/", 
        "2000/05/28/", 
        "2000/05/29/", 
        "2000/05/30/", 
        "2000/05/31/"
    ]
}
