{
    "Keys": [
        {
            "ETag": "\"d41d8cd98f00b204e9800998ecf8427e\"", 
            "Key": "1999/11/", 
            "Size": 0
        }
    ], 
    "CommonPrefixes": [
        "1999/11/01/", 
        "1999/11/02/", 
        "1999/11/03/", 
        "1999/11/04/", 
        "1999/11/05/", 
        "1999/11/06/", 
        "1999/11/07/", 
        "1999/11/08/", 
        "1999/11/09/", 
        "1999/11/10/", 
        "1999/11/11/", 
        "1999/11/12/", 
        "1999/11/13/", 
        "1999/11/14/", 
        "1999/11/15/", 
        "1999/11/16/", 
        "1999/11/17/", 
        "1999/11/18/", 
        "1999/11/19/", 
        "1999/11/20/", 
        "1999/11/21/", 
        "1999/11/22/", 
        "1999/11/23/", 
        "1999/11/24/", 
        "1999/11/25/", 
        "1999/11/26/", 
        "1999/11/27/", 
        "1999/11/28/", 
        "1999/11/29/", 
        "1999/11/30/"
    ]
}
