{
    "Keys": [
        {
            "ETag": "\"d41d8cd98f00b204e9800998ecf8427e\"", 
            "Key": "1996/02/", 
            "Size": 0
        }
    ], 
    "CommonPrefixes": [
        "1996/02/01/", 
        "1996/02/02/", 
        "1996/02/03/", 
        "1996/02/04/", 
        "1996/02/05/", 
        "1996/02/06/", 
        "1996/02/07/", 
        "1996/02/08/", 
        "1996/02/09/", 
        "1996/02/10/", 
        "1996/02/11/", 
        "1996/02/12/", 
        "1996/02/13/", 
        "1996/02/14/", 
        "1996/02/15/", 
        "1996/02/16/", 
        "1996/02/17/", 
        "1996/02/18/", 
        "1996/02/19/", 
        "1996/02/20/", 
        "1996/02/21/", 
        "1996/02/22/", 
        "1996/02/23/", 
        "1996/02/24/", 
        "1996/02/25/", 
        "1996/02/26/", 
        "1996/02/27/", 
        "1996/02/28/", 
        "1996/02/29/"
    ]
}
