{
    "Keys": [
        {
            "ETag": "\"d41d8cd98f00b204e9800998ecf8427e\"", 
            "Key": "2009/11/", 
            "Size": 0
        }
    ], 
    "CommonPrefixes": [
        "2009/11/01/", 
        "2009/11/02/", 
        "2009/11/03/", 
        "2009/11/04/", 
        "2009/11/05/", 
        "2009/11/06/", 
        "2009/11/07/", 
        "2009/11/08/", 
        "2009/11/09/", 
        "2009/11/10/", 
        "2009/11/11/", 
        "2009/11/12/", 
        "2009/11/13/", 
        "2009/11/14/", 
        "2009/11/15/", 
        "2009/11/16/", 
        "2009/11/17/", 
        "2009/11/18/", 
        "2009/11/19/", 
        "2009/11/20/", 
        "2009/11/21/", 
        "2009/11/22/", 
        "2009/11/23/", 
        "2009/11/24/", 
        "2009/11/25/", 
        "2009/11/26/", 
        "2009/11/27/", 
        "2009/11/28/", 
        "2009/11/29/", 
        "2009/11/30/"
    ]
}
