{
    "Keys": [
        {
            "ETag": "\"d41d8cd98f00b204e9800998ecf8427e\"", 
            "Key": "2003/04/", 
            "Size": 0
        }
    ], 
    "CommonPrefixes": [
        "2003/04/01/", 
        "2003/04/02/", 
        "2003/04/03/", 
        "2003/04/04/", 
        "2003/04/05/", 
        "2003/04/06/", 
        "2003/04/07/", 
        "2003/04/08/", 
        "2003/04/09/", 
        "2003/04/10/", 
        "2003/04/11/", 
        "2003/04/12/", 
        "2003/04/13/", 
        "2003/04/14/", 
        "2003/04/15/", 
        "2003/04/16/", 
        "2003/04/17/", 
        "2003/04/18/", 
        "2003/04/19/", 
        "2003/04/20/", 
        "2003/04/21/", 
        "2003/04/22/", 
        "2003/04/23/", 
        "2003/04/24/", 
        "2003/04/25/", 
        "2003/04/26/", 
        "2003/04/27/", 
        "2003/04/28/", 
        "2003/04/29/", 
        "2003/04/30/"
    ]
}
