{
    "Keys": [
        {
            "ETag": "\"d41d8cd98f00b204e9800998ecf8427e\"", 
            "Key": "2005/04/", 
            "Size": 0
        }
    ], 
    "CommonPrefixes": [
        "2005/04/01/", 
        "2005/04/02/", 
        "2005/04/03/", 
        "2005/04/04/", 
        "2005/04/05/", 
        "2005/04/06/", 
        "2005/04/07/", 
        "2005/04/08/", 
        "2005/04/09/", 
        "2005/04/10/", 
        "2005/04/11/", 
        "2005/04/12/", 
        "2005/04/13/", 
        "2005/04/14/", 
        "2005/04/15/", 
        "2005/04/16/", 
        "2005/04/17/", 
        "2005/04/18/", 
        "2005/04/19/", 
        "2005/04/20/", 
        "2005/04/21/", 
        "2005/04/22/", 
        "2005/04/23/", 
        "2005/04/24/", 
        "2005/04/25/", 
        "2005/04/26/", 
        "2005/04/27/", 
        "2005/04/28/", 
        "2005/04/29/", 
        "2005/04/30/"
    ]
}
