{
    "Keys": [
        {
            "ETag": "\"d41d8cd98f00b204e9800998ecf8427e\"", 
            "Key": "1999/09/", 
            "Size": 0
        }
    ], 
    "CommonPrefixes": [
        "1999/09/01/", 
        "1999/09/02/", 
        "1999/09/03/", 
        "1999/09/04/", 
        "1999/09/05/", 
        "1999/09/06/", 
        "1999/09/07/", 
        "1999/09/08/", 
        "1999/09/09/", 
        "1999/09/10/", 
        "1999/09/11/", 
        "1999/09/12/", 
        "1999/09/13/", 
        "1999/09/14/", 
        "1999/09/15/", 
        "1999/09/16/", 
        "1999/09/17/", 
        "1999/09/18/", 
        "1999/09/19/", 
        "1999/09/20/", 
        "1999/09/21/", 
        "1999/09/22/", 
        "1999/09/23/", 
        "1999/09/24/", 
        "1999/09/25/", 
        "1999/09/26/", 
        "1999/09/27/", 
        "1999/09/28/", 
        "1999/09/29/", 
        "1999/09/30/"
    ]
}
