{
    "Keys": [
        {
            "ETag": "\"d41d8cd98f00b204e9800998ecf8427e\"", 
            "Key": "2000/09/", 
            "Size": 0
        }
    ], 
    "CommonPrefixes": [
        "2000/09/01/", 
        "2000/09/02/", 
        "2000/09/03/", 
        "2000/09/04/", 
        "2000/09/05/", 
        "2000/09/06/", 
        "2000/09/07/", 
        "2000/09/08/", 
        "2000/09/09/", 
        "2000/09/10/", 
        "2000/09/11/", 
        "2000/09/12/", 
        "2000/09/13/", 
        "2000/09/14/", 
        "2000/09/15/", 
        "2000/09/16/", 
        "2000/09/17/", 
        "2000/09/18/", 
        "2000/09/19/", 
        "2000/09/20/", 
        "2000/09/21/", 
        "2000/09/22/", 
        "2000/09/23/", 
        "2000/09/24/", 
        "2000/09/25/", 
        "2000/09/26/", 
        "2000/09/27/", 
        "2000/09/28/", 
        "2000/09/29/", 
        "2000/09/30/"
    ]
}
