{
    "Keys": [
        {
            "ETag": "\"d41d8cd98f00b204e9800998ecf8427e\"", 
            "Key": "1992/02/", 
            "Size": 0
        }
    ], 
    "CommonPrefixes": [
        "1992/02/01/", 
        "1992/02/02/", 
        "1992/02/03/", 
        "1992/02/04/", 
        "1992/02/05/", 
        "1992/02/07/", 
        "1992/02/08/", 
        "1992/02/09/", 
        "1992/02/10/", 
        "1992/02/11/", 
        "1992/02/12/", 
        "1992/02/13/", 
        "1992/02/14/", 
        "1992/02/15/", 
        "1992/02/16/", 
        "1992/02/17/", 
        "1992/02/18/", 
        "1992/02/19/", 
        "1992/02/20/", 
        "1992/02/21/", 
        "1992/02/22/", 
        "1992/02/23/", 
        "1992/02/24/", 
        "1992/02/25/", 
        "1992/02/26/", 
        "1992/02/27/", 
        "1992/02/28/", 
        "1992/02/29/"
    ]
}
