{
    "Keys": [
        {
            "ETag": "\"d41d8cd98f00b204e9800998ecf8427e\"", 
            "Key": "2002/02/", 
            "Size": 0
        }
    ], 
    "CommonPrefixes": [
        "2002/02/01/", 
        "2002/02/02/", 
        "2002/02/03/", 
        "2002/02/04/", 
        "2002/02/05/", 
        "2002/02/06/", 
        "2002/02/07/", 
        "2002/02/08/", 
        "2002/02/09/", 
        "2002/02/10/", 
        "2002/02/11/", 
        "2002/02/12/", 
        "2002/02/13/", 
        "2002/02/14/", 
        "2002/02/15/", 
        "2002/02/16/", 
        "2002/02/17/", 
        "2002/02/18/", 
        "2002/02/19/", 
        "2002/02/20/", 
        "2002/02/21/", 
        "2002/02/22/", 
        "2002/02/23/", 
        "2002/02/24/", 
        "2002/02/25/", 
        "2002/02/26/", 
        "2002/02/27/", 
        "2002/02/28/"
    ]
}
