{
    "Keys": [
        {
            "ETag": "\"d41d8cd98f00b204e9800998ecf8427e\"", 
            "Key": "1993/10/", 
            "Size": 0
        }
    ], 
    "CommonPrefixes": [
        "1993/10/01/", 
        "1993/10/02/", 
        "1993/10/03/", 
        "1993/10/04/", 
        "1993/10/05/", 
        "1993/10/06/", 
        "1993/10/07/", 
        "1993/10/08/", 
        "1993/10/09/", 
        "1993/10/10/", 
        "1993/10/11/", 
        "1993/10/12/", 
        "1993/10/13/", 
        "1993/10/14/", 
        "1993/10/15/", 
        "1993/10/16/", 
        "1993/10/17/", 
        "1993/10/18/", 
        "1993/10/19/", 
        "1993/10/20/", 
        "1993/10/21/", 
        "1993/10/22/", 
        "1993/10/23/", 
        "1993/10/24/", 
        "1993/10/25/", 
        "1993/10/26/", 
        "1993/10/27/", 
        "1993/10/28/", 
        "1993/10/29/", 
        "1993/10/30/", 
        "1993/10/31/"
    ]
}
