{
    "Keys": [
        {
            "ETag": "\"d41d8cd98f00b204e9800998ecf8427e\"", 
            "Key": "2000/06/", 
            "Size": 0
        }
    ], 
    "CommonPrefixes": [
        "2000/06/01/", 
        "2000/06/02/", 
        "2000/06/03/", 
        "2000/06/04/", 
        "2000/06/05/", 
        "2000/06/06/", 
        "2000/06/07/", 
        "2000/06/08/", 
        "2000/06/09/", 
        "2000/06/10/", 
        "2000/06/11/", 
        "2000/06/12/", 
        "2000/06/13/", 
        "2000/06/14/", 
        "2000/06/15/", 
        "2000/06/16/", 
        "2000/06/17/", 
        "2000/06/18/", 
        "2000/06/19/", 
        "2000/06/20/", 
        "2000/06/21/", 
        "2000/06/22/", 
        "2000/06/23/", 
        "2000/06/24/", 
        "2000/06/25/", 
        "2000/06/26/", 
        "2000/06/27/", 
        "2000/06/28/", 
        "2000/06/29/", 
        "2000/06/30/"
    ]
}
