{
    "Keys": [
        {
            "ETag": "\"d41d8cd98f00b204e9800998ecf8427e\"", 
            "Key": "2003/01/", 
            "Size": 0
        }
    ], 
    "CommonPrefixes": [
        "2003/01/01/", 
        "2003/01/02/", 
        "2003/01/03/", 
        "2003/01/04/", 
        "2003/01/05/", 
        "2003/01/06/", 
        "2003/01/07/", 
        "2003/01/08/", 
        "2003/01/09/", 
        "2003/01/10/", 
        "2003/01/11/", 
        "2003/01/12/", 
        "2003/01/13/", 
        "2003/01/14/", 
        "2003/01/15/", 
        "2003/01/16/", 
        "2003/01/17/", 
        "2003/01/18/", 
        "2003/01/19/", 
        "2003/01/20/", 
        "2003/01/21/", 
        "2003/01/22/", 
        "2003/01/23/", 
        "2003/01/24/", 
        "2003/01/25/", 
        "2003/01/26/", 
        "2003/01/27/", 
        "2003/01/28/", 
        "2003/01/29/", 
        "2003/01/30/", 
        "2003/01/31/"
    ]
}
