{
    "Keys": [
        {
            "ETag": "\"d41d8cd98f00b204e9800998ecf8427e\"", 
            "Key": "2009/04/", 
            "Size": 0
        }
    ], 
    "CommonPrefixes": [
        "2009/04/01/", 
        "2009/04/02/", 
        "2009/04/03/", 
        "2009/04/04/", 
        "2009/04/05/", 
        "2009/04/06/", 
        "2009/04/07/", 
        "2009/04/08/", 
        "2009/04/09/", 
        "2009/04/10/", 
        "2009/04/11/", 
        "2009/04/12/", 
        "2009/04/13/", 
        "2009/04/14/", 
        "2009/04/15/", 
        "2009/04/16/", 
        "2009/04/17/", 
        "2009/04/18/", 
        "2009/04/19/", 
        "2009/04/20/", 
        "2009/04/21/", 
        "2009/04/22/", 
        "2009/04/23/", 
        "2009/04/24/", 
        "2009/04/25/", 
        "2009/04/26/", 
        "2009/04/27/", 
        "2009/04/28/", 
        "2009/04/29/", 
        "2009/04/30/"
    ]
}
