{
    "Keys": [
        {
            "ETag": "\"d41d8cd98f00b204e9800998ecf8427e\"", 
            "Key": "1992/01/", 
            "Size": 0
        }
    ], 
    "CommonPrefixes": [
        "1992/01/01/", 
        "1992/01/02/", 
        "1992/01/03/", 
        "1992/01/04/", 
        "1992/01/05/", 
        "1992/01/06/", 
        "1992/01/07/", 
        "1992/01/08/", 
        "1992/01/09/", 
        "1992/01/10/", 
        "1992/01/11/", 
        "1992/01/12/", 
        "1992/01/13/", 
        "1992/01/14/", 
        "1992/01/15/", 
        "1992/01/16/", 
        "1992/01/17/", 
        "1992/01/18/", 
        "1992/01/19/", 
        "1992/01/20/", 
        "1992/01/21/", 
        "1992/01/22/", 
        "1992/01/23/", 
        "1992/01/24/", 
        "1992/01/25/", 
        "1992/01/26/", 
        "1992/01/28/"
    ]
}
