{
    "Keys": [
        {
            "ETag": "\"d41d8cd98f00b204e9800998ecf8427e\"", 
            "Key": "1997/08/", 
            "Size": 0
        }
    ], 
    "CommonPrefixes": [
        "1997/08/01/", 
        "1997/08/02/", 
        "1997/08/03/", 
        "1997/08/04/", 
        "1997/08/05/", 
        "1997/08/06/", 
        "1997/08/07/", 
        "1997/08/08/", 
        "1997/08/09/", 
        "1997/08/10/", 
        "1997/08/11/", 
        "1997/08/12/", 
        "1997/08/13/", 
        "1997/08/14/", 
        "1997/08/15/", 
        "1997/08/16/", 
        "1997/08/17/", 
        "1997/08/18/", 
        "1997/08/19/", 
        "1997/08/20/", 
        "1997/08/21/", 
        "1997/08/22/", 
        "1997/08/23/", 
        "1997/08/24/", 
        "1997/08/25/", 
        "1997/08/26/", 
        "1997/08/27/", 
        "1997/08/28/", 
        "1997/08/29/", 
        "1997/08/30/", 
        "1997/08/31/"
    ]
}
