{
    "Keys": [
        {
            "ETag": "\"d41d8cd98f00b204e9800998ecf8427e\"", 
            "Key": "2005/11/", 
            "Size": 0
        }
    ], 
    "CommonPrefixes": [
        "2005/11/01/", 
        "2005/11/02/", 
        "2005/11/03/", 
        "2005/11/04/", 
        "2005/11/05/", 
        "2005/11/06/", 
        "2005/11/07/", 
        "2005/11/08/", 
        "2005/11/09/", 
        "2005/11/10/", 
        "2005/11/11/", 
        "2005/11/12/", 
        "2005/11/13/", 
        "2005/11/14/", 
        "2005/11/15/", 
        "2005/11/16/", 
        "2005/11/17/", 
        "2005/11/18/", 
        "2005/11/19/", 
        "2005/11/20/", 
        "2005/11/21/", 
        "2005/11/22/", 
        "2005/11/23/", 
        "2005/11/24/", 
        "2005/11/25/", 
        "2005/11/26/", 
        "2005/11/27/", 
        "2005/11/28/", 
        "2005/11/29/", 
        "2005/11/30/"
    ]
}
