{
    "Keys": [
        {
            "ETag": "\"d41d8cd98f00b204e9800998ecf8427e\"", 
            "Key": "1991/12/", 
            "Size": 0
        }
    ], 
    "CommonPrefixes": [
        "1991/12/01/", 
        "1991/12/02/", 
        "1991/12/03/", 
        "1991/12/04/", 
        "1991/12/09/", 
        "1991/12/10/", 
        "1991/12/13/", 
        "1991/12/14/", 
        "1991/12/17/", 
        "1991/12/18/", 
        "1991/12/19/", 
        "1991/12/20/", 
        "1991/12/21/", 
        "1991/12/22/", 
        "1991/12/23/", 
        "1991/12/24/", 
        "1991/12/26/", 
        "1991/12/27/", 
        "1991/12/28/", 
        "1991/12/31/"
    ]
}
