{
    "Keys": [
        {
            "ETag": "\"d41d8cd98f00b204e9800998ecf8427e\"", 
            "Key": "2005/05/", 
            "Size": 0
        }
    ], 
    "CommonPrefixes": [
        "2005/05/01/", 
        "2005/05/02/", 
        "2005/05/03/", 
        "2005/05/04/", 
        "2005/05/05/", 
        "2005/05/06/", 
        "2005/05/07/", 
        "2005/05/08/", 
        "2005/05/09/", 
        "2005/05/10/", 
        "2005/05/11/", 
        "2005/05/12/", 
        "2005/05/13/", 
        "2005/05/14/", 
        "2005/05/15/", 
        "2005/05/16/", 
        "2005/05/17/", 
        "2005/05/18/", 
        "2005/05/19/", 
        "2005/05/20/", 
        "2005/05/21/", 
        "2005/05/22/", 
        "2005/05/23/", 
        "2005/05/24/", 
        "2005/05/25/", 
        "2005/05/26/", 
        "2005/05/27/", 
        "2005/05/28/", 
        "2005/05/29/", 
        "2005/05/30/", 
        "2005/05/31/"
    ]
}
