{
    "Keys": null, 
    "CommonPrefixes": [
        "2014/12/01/", 
        "2014/12/02/", 
        "2014/12/03/", 
        "2014/12/04/", 
        "2014/12/05/", 
        "2014/12/06/", 
        "2014/12/07/", 
        "2014/12/08/", 
        "2014/12/09/", 
        "2014/12/10/", 
        "2014/12/11/", 
        "2014/12/12/", 
        "2014/12/13/", 
        "2014/12/14/", 
        "2014/12/15/", 
        "2014/12/16/", 
        "2014/12/17/", 
        "2014/12/18/", 
        "2014/12/19/", 
        "2014/12/20/", 
        "2014/12/21/", 
        "2014/12/22/", 
        "2014/12/23/", 
        "2014/12/24/", 
        "2014/12/25/", 
        "2014/12/26/", 
        "2014/12/27/", 
        "2014/12/28/", 
        "2014/12/29/", 
        "2014/12/30/", 
        "2014/12/31/"
    ]
}
