{
    "Keys": null, 
    "CommonPrefixes": [
        "2014/05/01/", 
        "2014/05/02/", 
        "2014/05/03/", 
        "2014/05/04/", 
        "2014/05/05/", 
        "2014/05/06/", 
        "2014/05/07/", 
        "2014/05/08/", 
        "2014/05/09/", 
        "2014/05/10/", 
        "2014/05/11/", 
        "2014/05/12/", 
        "2014/05/13/", 
        "2014/05/14/", 
        "2014/05/15/", 
        "2014/05/16/", 
        "2014/05/17/", 
        "2014/05/18/", 
        "2014/05/19/", 
        "2014/05/20/", 
        "2014/05/21/", 
        "2014/05/22/", 
        "2014/05/23/", 
        "2014/05/24/", 
        "2014/05/25/", 
        "2014/05/26/", 
        "2014/05/27/", 
        "2014/05/28/", 
        "2014/05/29/", 
        "2014/05/30/", 
        "2014/05/31/"
    ]
}
