{
    "Keys": null, 
    "CommonPrefixes": [
        "2011/05/01/", 
        "2011/05/02/", 
        "2011/05/03/", 
        "2011/05/04/", 
        "2011/05/05/", 
        "2011/05/06/", 
        "2011/05/07/", 
        "2011/05/08/", 
        "2011/05/09/", 
        "2011/05/10/", 
        "2011/05/11/", 
        "2011/05/12/", 
        "2011/05/13/", 
        "2011/05/14/", 
        "2011/05/15/", 
        "2011/05/16/", 
        "2011/05/17/", 
        "2011/05/18/", 
        "2011/05/19/", 
        "2011/05/20/", 
        "2011/05/21/", 
        "2011/05/22/", 
        "2011/05/23/", 
        "2011/05/24/", 
        "2011/05/25/", 
        "2011/05/26/", 
        "2011/05/27/", 
        "2011/05/28/", 
        "2011/05/29/", 
        "2011/05/30/", 
        "2011/05/31/"
    ]
}
