{
    "Keys": [
        {
            "ETag": "\"d41d8cd98f00b204e9800998ecf8427e\"", 
            "Key": "1995/09/", 
            "Size": 0
        }
    ], 
    "CommonPrefixes": [
        "1995/09/01/", 
        "1995/09/02/", 
        "1995/09/03/", 
        "1995/09/04/", 
        "1995/09/05/", 
        "1995/09/06/", 
        "1995/09/07/", 
        "1995/09/08/", 
        "1995/09/09/", 
        "1995/09/10/", 
        "1995/09/11/", 
        "1995/09/12/", 
        "1995/09/13/", 
        "1995/09/14/", 
        "1995/09/15/", 
        "1995/09/16/", 
        "1995/09/17/", 
        "1995/09/18/", 
        "1995/09/19/", 
        "1995/09/20/", 
        "1995/09/21/", 
        "1995/09/22/", 
        "1995/09/23/", 
        "1995/09/24/", 
        "1995/09/25/", 
        "1995/09/26/", 
        "1995/09/27/", 
        "1995/09/28/", 
        "1995/09/29/", 
        "1995/09/30/"
    ]
}
