{
    "Keys": [
        {
            "ETag": "\"d41d8cd98f00b204e9800998ecf8427e\"", 
            "Key": "2007/04/", 
            "Size": 0
        }
    ], 
    "CommonPrefixes": [
        "2007/04/01/", 
        "2007/04/02/", 
        "2007/04/03/", 
        "2007/04/04/", 
        "2007/04/05/", 
        "2007/04/06/", 
        "2007/04/07/", 
        "2007/04/08/", 
        "2007/04/09/", 
        "2007/04/10/", 
        "2007/04/11/", 
        "2007/04/12/", 
        "2007/04/13/", 
        "2007/04/14/", 
        "2007/04/15/", 
        "2007/04/16/", 
        "2007/04/17/", 
        "2007/04/18/", 
        "2007/04/19/", 
        "2007/04/20/", 
        "2007/04/21/", 
        "2007/04/22/", 
        "2007/04/23/", 
        "2007/04/24/", 
        "2007/04/25/", 
        "2007/04/26/", 
        "2007/04/27/", 
        "2007/04/28/", 
        "2007/04/29/", 
        "2007/04/30/"
    ]
}
