{
    "Keys": [
        {
            "ETag": "\"d41d8cd98f00b204e9800998ecf8427e\"", 
            "Key": "1998/11/", 
            "Size": 0
        }
    ], 
    "CommonPrefixes": [
        "1998/11/01/", 
        "1998/11/02/", 
        "1998/11/03/", 
        "1998/11/04/", 
        "1998/11/05/", 
        "1998/11/06/", 
        "1998/11/07/", 
        "1998/11/08/", 
        "1998/11/09/", 
        "1998/11/10/", 
        "1998/11/11/", 
        "1998/11/12/", 
        "1998/11/13/", 
        "1998/11/14/", 
        "1998/11/15/", 
        "1998/11/16/", 
        "1998/11/17/", 
        "1998/11/18/", 
        "1998/11/19/", 
        "1998/11/20/", 
        "1998/11/21/", 
        "1998/11/22/", 
        "1998/11/23/", 
        "1998/11/24/", 
        "1998/11/25/", 
        "1998/11/26/", 
        "1998/11/27/", 
        "1998/11/28/", 
        "1998/11/29/", 
        "1998/11/30/"
    ]
}
