{
    "Keys": [
        {
            "ETag": "\"d41d8cd98f00b204e9800998ecf8427e\"", 
            "Key": "2012/03/", 
            "Size": 0
        }
    ], 
    "CommonPrefixes": [
        "2012/03/01/", 
        "2012/03/02/", 
        "2012/03/03/", 
        "2012/03/04/", 
        "2012/03/05/", 
        "2012/03/06/", 
        "2012/03/07/", 
        "2012/03/08/", 
        "2012/03/09/", 
        "2012/03/10/", 
        "2012/03/11/", 
        "2012/03/12/", 
        "2012/03/13/", 
        "2012/03/14/", 
        "2012/03/15/", 
        "2012/03/16/", 
        "2012/03/17/", 
        "2012/03/18/", 
        "2012/03/19/", 
        "2012/03/20/", 
        "2012/03/21/", 
        "2012/03/22/", 
        "2012/03/23/", 
        "2012/03/24/", 
        "2012/03/25/", 
        "2012/03/26/", 
        "2012/03/27/", 
        "2012/03/28/", 
        "2012/03/29/", 
        "2012/03/30/", 
        "2012/03/31/"
    ]
}
