{
    "Keys": [
        {
            "ETag": "\"d41d8cd98f00b204e9800998ecf8427e\"", 
            "Key": "2015/12/", 
            "Size": 0
        }
    ], 
    "CommonPrefixes": [
        "2015/12/01/", 
        "2015/12/02/", 
        "2015/12/03/", 
        "2015/12/04/", 
        "2015/12/05/", 
        "2015/12/06/", 
        "2015/12/07/", 
        "2015/12/08/", 
        "2015/12/09/", 
        "2015/12/10/", 
        "2015/12/11/", 
        "2015/12/12/", 
        "2015/12/13/", 
        "2015/12/14/", 
        "2015/12/15/", 
        "2015/12/16/", 
        "2015/12/17/", 
        "2015/12/18/", 
        "2015/12/19/", 
        "2015/12/20/", 
        "2015/12/21/", 
        "2015/12/22/", 
        "2015/12/23/", 
        "2015/12/24/", 
        "2015/12/25/", 
        "2015/12/26/", 
        "2015/12/27/", 
        "2015/12/28/", 
        "2015/12/29/", 
        "2015/12/30/", 
        "2015/12/31/"
    ]
}
