{
    "Keys": null, 
    "CommonPrefixes": [
        "2017/02/01/", 
        "2017/02/02/", 
        "2017/02/03/", 
        "2017/02/04/", 
        "2017/02/05/", 
        "2017/02/06/", 
        "2017/02/07/", 
        "2017/02/08/", 
        "2017/02/09/", 
        "2017/02/10/", 
        "2017/02/11/", 
        "2017/02/12/", 
        "2017/02/13/", 
        "2017/02/14/", 
        "2017/02/15/", 
        "2017/02/16/", 
        "2017/02/17/", 
        "2017/02/18/", 
        "2017/02/19/", 
        "2017/02/20/", 
        "2017/02/21/", 
        "2017/02/22/", 
        "2017/02/23/", 
        "2017/02/24/", 
        "2017/02/25/", 
        "2017/02/26/", 
        "2017/02/27/", 
        "2017/02/28/"
    ]
}
