{
    "Keys": [
        {
            "ETag": "\"d41d8cd98f00b204e9800998ecf8427e\"", 
            "Key": "1998/04/", 
            "Size": 0
        }
    ], 
    "CommonPrefixes": [
        "1998/04/01/", 
        "1998/04/02/", 
        "1998/04/03/", 
        "1998/04/04/", 
        "1998/04/05/", 
        "1998/04/06/", 
        "1998/04/07/", 
        "1998/04/08/", 
        "1998/04/09/", 
        "1998/04/10/", 
        "1998/04/11/", 
        "1998/04/12/", 
        "1998/04/13/", 
        "1998/04/14/", 
        "1998/04/15/", 
        "1998/04/16/", 
        "1998/04/17/", 
        "1998/04/18/", 
        "1998/04/19/", 
        "1998/04/20/", 
        "1998/04/21/", 
        "1998/04/22/", 
        "1998/04/23/", 
        "1998/04/24/", 
        "1998/04/25/", 
        "1998/04/26/", 
        "1998/04/27/", 
        "1998/04/28/", 
        "1998/04/29/", 
        "1998/04/30/"
    ]
}
