{
    "Keys": [
        {
            "ETag": "\"d41d8cd98f00b204e9800998ecf8427e\"", 
            "Key": "1996/03/", 
            "Size": 0
        }
    ], 
    "CommonPrefixes": [
        "1996/03/01/", 
        "1996/03/02/", 
        "1996/03/03/", 
        "1996/03/04/", 
        "1996/03/05/", 
        "1996/03/06/", 
        "1996/03/07/", 
        "1996/03/08/", 
        "1996/03/09/", 
        "1996/03/10/", 
        "1996/03/11/", 
        "1996/03/12/", 
        "1996/03/13/", 
        "1996/03/14/", 
        "1996/03/15/", 
        "1996/03/16/", 
        "1996/03/17/", 
        "1996/03/18/", 
        "1996/03/19/", 
        "1996/03/20/", 
        "1996/03/21/", 
        "1996/03/22/", 
        "1996/03/23/", 
        "1996/03/24/", 
        "1996/03/25/", 
        "1996/03/26/", 
        "1996/03/27/", 
        "1996/03/28/", 
        "1996/03/29/", 
        "1996/03/30/", 
        "1996/03/31/"
    ]
}
