{
    "Keys": [
        {
            "ETag": "\"d41d8cd98f00b204e9800998ecf8427e\"", 
            "Key": "2002/03/", 
            "Size": 0
        }
    ], 
    "CommonPrefixes": [
        "2002/03/01/", 
        "2002/03/02/", 
        "2002/03/03/", 
        "2002/03/04/", 
        "2002/03/05/", 
        "2002/03/06/", 
        "2002/03/07/", 
        "2002/03/08/", 
        "2002/03/09/", 
        "2002/03/10/", 
        "2002/03/11/", 
        "2002/03/12/", 
        "2002/03/13/", 
        "2002/03/14/", 
        "2002/03/15/", 
        "2002/03/16/", 
        "2002/03/17/", 
        "2002/03/18/", 
        "2002/03/19/", 
        "2002/03/20/", 
        "2002/03/21/", 
        "2002/03/22/", 
        "2002/03/23/", 
        "2002/03/24/", 
        "2002/03/25/", 
        "2002/03/26/", 
        "2002/03/27/", 
        "2002/03/28/", 
        "2002/03/29/", 
        "2002/03/30/", 
        "2002/03/31/"
    ]
}
