{
    "Keys": [
        {
            "ETag": "\"d41d8cd98f00b204e9800998ecf8427e\"", 
            "Key": "1997/01/", 
            "Size": 0
        }
    ], 
    "CommonPrefixes": [
        "1997/01/01/", 
        "1997/01/02/", 
        "1997/01/03/", 
        "1997/01/04/", 
        "1997/01/05/", 
        "1997/01/06/", 
        "1997/01/07/", 
        "1997/01/08/", 
        "1997/01/09/", 
        "1997/01/10/", 
        "1997/01/11/", 
        "1997/01/12/", 
        "1997/01/13/", 
        "1997/01/14/", 
        "1997/01/15/", 
        "1997/01/16/", 
        "1997/01/17/", 
        "1997/01/18/", 
        "1997/01/19/", 
        "1997/01/20/", 
        "1997/01/21/", 
        "1997/01/22/", 
        "1997/01/23/", 
        "1997/01/24/", 
        "1997/01/25/", 
        "1997/01/26/", 
        "1997/01/27/", 
        "1997/01/28/", 
        "1997/01/29/", 
        "1997/01/30/", 
        "1997/01/31/"
    ]
}
