{
    "Keys": [
        {
            "ETag": "\"d41d8cd98f00b204e9800998ecf8427e\"", 
            "Key": "1994/04/", 
            "Size": 0
        }
    ], 
    "CommonPrefixes": [
        "1994/04/01/", 
        "1994/04/02/", 
        "1994/04/03/", 
        "1994/04/04/", 
        "1994/04/05/", 
        "1994/04/06/", 
        "1994/04/07/", 
        "1994/04/08/", 
        "1994/04/09/", 
        "1994/04/10/", 
        "1994/04/11/", 
        "1994/04/12/", 
        "1994/04/13/", 
        "1994/04/14/", 
        "1994/04/15/", 
        "1994/04/16/", 
        "1994/04/17/", 
        "1994/04/18/", 
        "1994/04/19/", 
        "1994/04/20/", 
        "1994/04/21/", 
        "1994/04/22/", 
        "1994/04/23/", 
        "1994/04/24/", 
        "1994/04/25/", 
        "1994/04/26/", 
        "1994/04/27/", 
        "1994/04/28/", 
        "1994/04/29/", 
        "1994/04/30/"
    ]
}
