{
    "Keys": [
        {
            "ETag": "\"d41d8cd98f00b204e9800998ecf8427e\"", 
            "Key": "1999/06/", 
            "Size": 0
        }
    ], 
    "CommonPrefixes": [
        "1999/06/01/", 
        "1999/06/02/", 
        "1999/06/03/", 
        "1999/06/04/", 
        "1999/06/05/", 
        "1999/06/06/", 
        "1999/06/07/", 
        "1999/06/08/", 
        "1999/06/09/", 
        "1999/06/10/", 
        "1999/06/11/", 
        "1999/06/12/", 
        "1999/06/13/", 
        "1999/06/14/", 
        "1999/06/15/", 
        "1999/06/16/", 
        "1999/06/17/", 
        "1999/06/18/", 
        "1999/06/19/", 
        "1999/06/20/", 
        "1999/06/21/", 
        "1999/06/22/", 
        "1999/06/23/", 
        "1999/06/24/", 
        "1999/06/25/", 
        "1999/06/26/", 
        "1999/06/27/", 
        "1999/06/28/", 
        "1999/06/29/", 
        "1999/06/30/"
    ]
}
