{
    "Keys": [
        {
            "ETag": "\"d41d8cd98f00b204e9800998ecf8427e\"", 
            "Key": "1998/08/", 
            "Size": 0
        }
    ], 
    "CommonPrefixes": [
        "1998/08/01/", 
        "1998/08/02/", 
        "1998/08/03/", 
        "1998/08/04/", 
        "1998/08/05/", 
        "1998/08/06/", 
        "1998/08/07/", 
        "1998/08/08/", 
        "1998/08/09/", 
        "1998/08/10/", 
        "1998/08/11/", 
        "1998/08/12/", 
        "1998/08/13/", 
        "1998/08/14/", 
        "1998/08/15/", 
        "1998/08/16/", 
        "1998/08/17/", 
        "1998/08/18/", 
        "1998/08/19/", 
        "1998/08/20/", 
        "1998/08/21/", 
        "1998/08/22/", 
        "1998/08/23/", 
        "1998/08/24/", 
        "1998/08/25/", 
        "1998/08/26/", 
        "1998/08/27/", 
        "1998/08/28/", 
        "1998/08/29/", 
        "1998/08/30/", 
        "1998/08/31/"
    ]
}
