{
    "Keys": [
        {
            "ETag": "\"d41d8cd98f00b204e9800998ecf8427e\"", 
            "Key": "2012/02/", 
            "Size": 0
        }
    ], 
    "CommonPrefixes": [
        "2012/02/01/", 
        "2012/02/02/", 
        "2012/02/03/", 
        "2012/02/04/", 
        "2012/02/05/", 
        "2012/02/06/", 
        "2012/02/07/", 
        "2012/02/08/", 
        "2012/02/09/", 
        "2012/02/10/", 
        "2012/02/11/", 
        "2012/02/12/", 
        "2012/02/13/", 
        "2012/02/14/", 
        "2012/02/15/", 
        "2012/02/16/", 
        "2012/02/17/", 
        "2012/02/18/", 
        "2012/02/19/", 
        "2012/02/20/", 
        "2012/02/21/", 
        "2012/02/22/", 
        "2012/02/23/", 
        "2012/02/24/", 
        "2012/02/25/", 
        "2012/02/26/", 
        "2012/02/27/", 
        "2012/02/28/", 
        "2012/02/29/"
    ]
}
