{
    "Keys": [
        {
            "ETag": "\"d41d8cd98f00b204e9800998ecf8427e\"", 
            "Key": "1994/03/", 
            "Size": 0
        }
    ], 
    "CommonPrefixes": [
        "1994/03/01/", 
        "1994/03/02/", 
        "1994/03/03/", 
        "1994/03/04/", 
        "1994/03/05/", 
        "1994/03/06/", 
        "1994/03/07/", 
        "1994/03/08/", 
        "1994/03/09/", 
        "1994/03/10/", 
        "1994/03/11/", 
        "1994/03/12/", 
        "1994/03/13/", 
        "1994/03/14/", 
        "1994/03/15/", 
        "1994/03/16/", 
        "1994/03/17/", 
        "1994/03/18/", 
        "1994/03/19/", 
        "1994/03/20/", 
        "1994/03/21/", 
        "1994/03/22/", 
        "1994/03/23/", 
        "1994/03/24/", 
        "1994/03/25/", 
        "1994/03/26/", 
        "1994/03/27/", 
        "1994/03/28/", 
        "1994/03/29/", 
        "1994/03/30/", 
        "1994/03/31/"
    ]
}
