{
    "Keys": [
        {
            "ETag": "\"d41d8cd98f00b204e9800998ecf8427e\"", 
            "Key": "1993/12/", 
            "Size": 0
        }
    ], 
    "CommonPrefixes": [
        "1993/12/01/", 
        "1993/12/02/", 
        "1993/12/03/", 
        "1993/12/04/", 
        "1993/12/05/", 
        "1993/12/06/", 
        "1993/12/07/", 
        "1993/12/08/", 
        "1993/12/09/", 
        "1993/12/10/", 
        "1993/12/11/", 
        "1993/12/12/", 
        "1993/12/13/", 
        "1993/12/14/", 
        "1993/12/15/", 
        "1993/12/16/", 
        "1993/12/17/", 
        "1993/12/18/", 
        "1993/12/19/", 
        "1993/12/20/", 
        "1993/12/21/", 
        "1993/12/22/", 
        "1993/12/23/", 
        "1993/12/24/", 
        "1993/12/25/", 
        "1993/12/26/", 
        "1993/12/27/", 
        "1993/12/28/", 
        "1993/12/29/", 
        "1993/12/30/", 
        "1993/12/31/"
    ]
}
