{
    "Keys": [
        {
            "ETag": "\"d41d8cd98f00b204e9800998ecf8427e\"", 
            "Key": "1998/07/", 
            "Size": 0
        }
    ], 
    "CommonPrefixes": [
        "1998/07/01/", 
        "1998/07/02/", 
        "1998/07/03/", 
        "1998/07/04/", 
        "1998/07/05/", 
        "1998/07/06/", 
        "1998/07/07/", 
        "1998/07/08/", 
        "1998/07/09/", 
        "1998/07/10/", 
        "1998/07/11/", 
        "1998/07/12/", 
        "1998/07/13/", 
        "1998/07/14/", 
        "1998/07/15/", 
        "1998/07/16/", 
        "1998/07/17/", 
        "1998/07/18/", 
        "1998/07/19/", 
        "1998/07/20/", 
        "1998/07/21/", 
        "1998/07/22/", 
        "1998/07/23/", 
        "1998/07/24/", 
        "1998/07/25/", 
        "1998/07/26/", 
        "1998/07/27/", 
        "1998/07/28/", 
        "1998/07/29/", 
        "1998/07/30/", 
        "1998/07/31/"
    ]
}
