{
    "Keys": null, 
    "CommonPrefixes": [
        "2014/11/01/", 
        "2014/11/02/", 
        "2014/11/03/", 
        "2014/11/04/", 
        "2014/11/05/", 
        "2014/11/06/", 
        "2014/11/07/", 
        "2014/11/08/", 
        "2014/11/09/", 
        "2014/11/10/", 
        "2014/11/11/", 
        "2014/11/12/", 
        "2014/11/14/", 
        "2014/11/15/", 
        "2014/11/16/", 
        "2014/11/17/", 
        "2014/11/18/", 
        "2014/11/19/", 
        "2014/11/20/", 
        "2014/11/21/", 
        "2014/11/22/", 
        "2014/11/23/", 
        "2014/11/24/", 
        "2014/11/25/", 
        "2014/11/26/", 
        "2014/11/27/", 
        "2014/11/28/", 
        "2014/11/29/", 
        "2014/11/30/"
    ]
}
