{
    "Keys": [
        {
            "ETag": "\"d41d8cd98f00b204e9800998ecf8427e\"", 
            "Key": "1994/01/", 
            "Size": 0
        }
    ], 
    "CommonPrefixes": [
        "1994/01/01/", 
        "1994/01/02/", 
        "1994/01/03/", 
        "1994/01/04/", 
        "1994/01/05/", 
        "1994/01/06/", 
        "1994/01/07/", 
        "1994/01/08/", 
        "1994/01/09/", 
        "1994/01/10/", 
        "1994/01/11/", 
        "1994/01/12/", 
        "1994/01/13/", 
        "1994/01/14/", 
        "1994/01/15/", 
        "1994/01/16/", 
        "1994/01/17/", 
        "1994/01/18/", 
        "1994/01/19/", 
        "1994/01/20/", 
        "1994/01/21/", 
        "1994/01/22/", 
        "1994/01/23/", 
        "1994/01/24/", 
        "1994/01/25/", 
        "1994/01/26/", 
        "1994/01/27/", 
        "1994/01/28/", 
        "1994/01/29/", 
        "1994/01/30/", 
        "1994/01/31/"
    ]
}
