{
    "Keys": [
        {
            "ETag": "\"d41d8cd98f00b204e9800998ecf8427e\"", 
            "Key": "2002/10/", 
            "Size": 0
        }
    ], 
    "CommonPrefixes": [
        "2002/10/01/", 
        "2002/10/02/", 
        "2002/10/03/", 
        "2002/10/04/", 
        "2002/10/05/", 
        "2002/10/06/", 
        "2002/10/07/", 
        "2002/10/08/", 
        "2002/10/09/", 
        "2002/10/10/", 
        "2002/10/11/", 
        "2002/10/12/", 
        "2002/10/13/", 
        "2002/10/14/", 
        "2002/10/15/", 
        "2002/10/16/", 
        "2002/10/17/", 
        "2002/10/18/", 
        "2002/10/19/", 
        "2002/10/20/", 
        "2002/10/21/", 
        "2002/10/22/", 
        "2002/10/23/", 
        "2002/10/24/", 
        "2002/10/25/", 
        "2002/10/26/", 
        "2002/10/27/", 
        "2002/10/28/", 
        "2002/10/29/", 
        "2002/10/30/", 
        "2002/10/31/"
    ]
}
