{
    "Keys": [
        {
            "ETag": "\"d41d8cd98f00b204e9800998ecf8427e\"", 
            "Key": "1991/07/", 
            "Size": 0
        }
    ], 
    "CommonPrefixes": [
        "1991/07/03/", 
        "1991/07/04/", 
        "1991/07/05/", 
        "1991/07/06/", 
        "1991/07/07/", 
        "1991/07/11/", 
        "1991/07/12/", 
        "1991/07/13/", 
        "1991/07/14/", 
        "1991/07/15/", 
        "1991/07/16/", 
        "1991/07/17/", 
        "1991/07/18/", 
        "1991/07/19/", 
        "1991/07/20/", 
        "1991/07/21/", 
        "1991/07/22/", 
        "1991/07/23/", 
        "1991/07/24/", 
        "1991/07/25/", 
        "1991/07/26/", 
        "1991/07/27/"
    ]
}
