{
    "Keys": [
        {
            "ETag": "\"d41d8cd98f00b204e9800998ecf8427e\"", 
            "Key": "2007/10/", 
            "Size": 0
        }
    ], 
    "CommonPrefixes": [
        "2007/10/01/", 
        "2007/10/02/", 
        "2007/10/03/", 
        "2007/10/04/", 
        "2007/10/05/", 
        "2007/10/06/", 
        "2007/10/07/", 
        "2007/10/08/", 
        "2007/10/09/", 
        "2007/10/10/", 
        "2007/10/11/", 
        "2007/10/12/", 
        "2007/10/13/", 
        "2007/10/14/", 
        "2007/10/15/", 
        "2007/10/16/", 
        "2007/10/17/", 
        "2007/10/18/", 
        "2007/10/19/", 
        "2007/10/20/", 
        "2007/10/21/", 
        "2007/10/22/", 
        "2007/10/23/", 
        "2007/10/24/", 
        "2007/10/25/", 
        "2007/10/26/", 
        "2007/10/27/", 
        "2007/10/28/", 
        "2007/10/29/", 
        "2007/10/30/", 
        "2007/10/31/"
    ]
}
