{
    "Keys": [
        {
            "ETag": "\"d41d8cd98f00b204e9800998ecf8427e\"", 
            "Key": "2006/10/", 
            "Size": 0
        }
    ], 
    "CommonPrefixes": [
        "2006/10/01/", 
        "2006/10/02/", 
        "2006/10/03/", 
        "2006/10/04/", 
        "2006/10/05/", 
        "2006/10/06/", 
        "2006/10/07/", 
        "2006/10/08/", 
        "2006/10/09/", 
        "2006/10/10/", 
        "2006/10/11/", 
        "2006/10/12/", 
        "2006/10/13/", 
        "2006/10/14/", 
        "2006/10/15/", 
        "2006/10/16/", 
        "2006/10/17/", 
        "2006/10/18/", 
        "2006/10/19/", 
        "2006/10/20/", 
        "2006/10/21/", 
        "2006/10/22/", 
        "2006/10/23/", 
        "2006/10/24/", 
        "2006/10/25/", 
        "2006/10/26/", 
        "2006/10/27/", 
        "2006/10/28/", 
        "2006/10/29/", 
        "2006/10/30/", 
        "2006/10/31/"
    ]
}
