{
    "Keys": [
        {
            "ETag": "\"d41d8cd98f00b204e9800998ecf8427e\"", 
            "Key": "2004/11/", 
            "Size": 0
        }
    ], 
    "CommonPrefixes": [
        "2004/11/01/", 
        "2004/11/02/", 
        "2004/11/03/", 
        "2004/11/04/", 
        "2004/11/05/", 
        "2004/11/06/", 
        "2004/11/07/", 
        "2004/11/08/", 
        "2004/11/09/", 
        "2004/11/10/", 
        "2004/11/11/", 
        "2004/11/12/", 
        "2004/11/13/", 
        "2004/11/14/", 
        "2004/11/15/", 
        "2004/11/16/", 
        "2004/11/17/", 
        "2004/11/18/", 
        "2004/11/19/", 
        "2004/11/20/", 
        "2004/11/21/", 
        "2004/11/22/", 
        "2004/11/23/", 
        "2004/11/24/", 
        "2004/11/25/", 
        "2004/11/26/", 
        "2004/11/27/", 
        "2004/11/28/", 
        "2004/11/29/", 
        "2004/11/30/"
    ]
}
