{
    "Keys": [
        {
            "ETag": "\"d41d8cd98f00b204e9800998ecf8427e\"", 
            "Key": "2006/09/", 
            "Size": 0
        }
    ], 
    "CommonPrefixes": [
        "2006/09/01/", 
        "2006/09/02/", 
        "2006/09/03/", 
        "2006/09/04/", 
        "2006/09/05/", 
        "2006/09/06/", 
        "2006/09/07/", 
        "2006/09/08/", 
        "2006/09/09/", 
        "2006/09/10/", 
        "2006/09/11/", 
        "2006/09/12/", 
        "2006/09/13/", 
        "2006/09/14/", 
        "2006/09/15/", 
        "2006/09/16/", 
        "2006/09/17/", 
        "2006/09/18/", 
        "2006/09/19/", 
        "2006/09/20/", 
        "2006/09/21/", 
        "2006/09/22/", 
        "2006/09/23/", 
        "2006/09/24/", 
        "2006/09/25/", 
        "2006/09/26/", 
        "2006/09/27/", 
        "2006/09/28/", 
        "2006/09/29/", 
        "2006/09/30/"
    ]
}
