{
    "Keys": [
        {
            "ETag": "\"d41d8cd98f00b204e9800998ecf8427e\"", 
            "Key": "1995/03/", 
            "Size": 0
        }
    ], 
    "CommonPrefixes": [
        "1995/03/01/", 
        "1995/03/02/", 
        "1995/03/03/", 
        "1995/03/04/", 
        "1995/03/05/", 
        "1995/03/06/", 
        "1995/03/07/", 
        "1995/03/08/", 
        "1995/03/09/", 
        "1995/03/10/", 
        "1995/03/11/", 
        "1995/03/12/", 
        "1995/03/13/", 
        "1995/03/14/", 
        "1995/03/15/", 
        "1995/03/16/", 
        "1995/03/17/", 
        "1995/03/18/", 
        "1995/03/19/", 
        "1995/03/20/", 
        "1995/03/21/", 
        "1995/03/22/", 
        "1995/03/23/", 
        "1995/03/24/", 
        "1995/03/25/", 
        "1995/03/26/", 
        "1995/03/27/", 
        "1995/03/28/", 
        "1995/03/29/", 
        "1995/03/30/", 
        "1995/03/31/"
    ]
}
