{
    "Keys": [
        {
            "ETag": "\"d41d8cd98f00b204e9800998ecf8427e\"", 
            "Key": "1998/01/", 
            "Size": 0
        }
    ], 
    "CommonPrefixes": [
        "1998/01/01/", 
        "1998/01/02/", 
        "1998/01/03/", 
        "1998/01/04/", 
        "1998/01/05/", 
        "1998/01/06/", 
        "1998/01/07/", 
        "1998/01/08/", 
        "1998/01/09/", 
        "1998/01/10/", 
        "1998/01/11/", 
        "1998/01/12/", 
        "1998/01/13/", 
        "1998/01/14/", 
        "1998/01/15/", 
        "1998/01/16/", 
        "1998/01/17/", 
        "1998/01/18/", 
        "1998/01/19/", 
        "1998/01/20/", 
        "1998/01/21/", 
        "1998/01/22/", 
        "1998/01/23/", 
        "1998/01/24/", 
        "1998/01/25/", 
        "1998/01/26/", 
        "1998/01/27/", 
        "1998/01/28/", 
        "1998/01/29/", 
        "1998/01/30/", 
        "1998/01/31/"
    ]
}
