{
    "Keys": null, 
    "CommonPrefixes": [
        "2014/01/", 
        "2014/02/", 
        "2014/03/", 
        "2014/04/", 
        "2014/05/", 
        "2014/06/", 
        "2014/07/", 
        "2014/08/", 
        "2014/09/", 
        "2014/10/", 
        "2014/11/", 
        "2014/12/"
    ]
}
