{
    "Keys": [
        {
            "ETag": "\"d41d8cd98f00b204e9800998ecf8427e\"", 
            "Key": "2006/08/", 
            "Size": 0
        }
    ], 
    "CommonPrefixes": [
        "2006/08/01/", 
        "2006/08/02/", 
        "2006/08/03/", 
        "2006/08/04/", 
        "2006/08/05/", 
        "2006/08/06/", 
        "2006/08/07/", 
        "2006/08/08/", 
        "2006/08/09/", 
        "2006/08/10/", 
        "2006/08/11/", 
        "2006/08/12/", 
        "2006/08/13/", 
        "2006/08/14/", 
        "2006/08/15/", 
        "2006/08/16/", 
        "2006/08/17/", 
        "2006/08/18/", 
        "2006/08/19/", 
        "2006/08/20/", 
        "2006/08/21/", 
        "2006/08/22/", 
        "2006/08/23/", 
        "2006/08/24/", 
        "2006/08/25/", 
        "2006/08/26/", 
        "2006/08/27/", 
        "2006/08/28/", 
        "2006/08/29/", 
        "2006/08/30/", 
        "2006/08/31/"
    ]
}
