{
    "Keys": [
        {
            "ETag": "\"d41d8cd98f00b204e9800998ecf8427e\"", 
            "Key": "1997/09/", 
            "Size": 0
        }
    ], 
    "CommonPrefixes": [
        "1997/09/01/", 
        "1997/09/02/", 
        "1997/09/03/", 
        "1997/09/04/", 
        "1997/09/05/", 
        "1997/09/06/", 
        "1997/09/07/", 
        "1997/09/08/", 
        "1997/09/09/", 
        "1997/09/10/", 
        "1997/09/11/", 
        "1997/09/12/", 
        "1997/09/13/", 
        "1997/09/14/", 
        "1997/09/15/", 
        "1997/09/16/", 
        "1997/09/17/", 
        "1997/09/18/", 
        "1997/09/19/", 
        "1997/09/20/", 
        "1997/09/21/", 
        "1997/09/22/", 
        "1997/09/23/", 
        "1997/09/24/", 
        "1997/09/25/", 
        "1997/09/26/", 
        "1997/09/27/", 
        "1997/09/28/", 
        "1997/09/29/", 
        "1997/09/30/"
    ]
}
