{
    "Keys": [
        {
            "ETag": "\"d41d8cd98f00b204e9800998ecf8427e\"", 
            "Key": "1991/02/", 
            "Size": 0
        }
    ], 
    "CommonPrefixes": [
        "1991/02/01/", 
        "1991/02/02/", 
        "1991/02/03/", 
        "1991/02/04/", 
        "1991/02/05/", 
        "1991/02/06/", 
        "1991/02/07/", 
        "1991/02/08/", 
        "1991/02/09/", 
        "1991/02/10/", 
        "1991/02/11/", 
        "1991/02/12/", 
        "1991/02/13/", 
        "1991/02/14/", 
        "1991/02/15/", 
        "1991/02/16/", 
        "1991/02/17/", 
        "1991/02/18/", 
        "1991/02/19/", 
        "1991/02/20/", 
        "1991/02/21/", 
        "1991/02/22/", 
        "1991/02/23/", 
        "1991/02/24/", 
        "1991/02/25/", 
        "1991/02/26/", 
        "1991/02/27/", 
        "1991/02/28/"
    ]
}
