{
    "Keys": [
        {
            "ETag": "\"d41d8cd98f00b204e9800998ecf8427e\"", 
            "Key": "1993/04/", 
            "Size": 0
        }
    ], 
    "CommonPrefixes": [
        "1993/04/01/", 
        "1993/04/02/", 
        "1993/04/03/", 
        "1993/04/04/", 
        "1993/04/05/", 
        "1993/04/06/", 
        "1993/04/07/", 
        "1993/04/08/", 
        "1993/04/09/", 
        "1993/04/10/", 
        "1993/04/11/", 
        "1993/04/12/", 
        "1993/04/13/", 
        "1993/04/14/", 
        "1993/04/15/", 
        "1993/04/16/", 
        "1993/04/17/", 
        "1993/04/18/", 
        "1993/04/19/", 
        "1993/04/20/", 
        "1993/04/21/", 
        "1993/04/22/", 
        "1993/04/23/", 
        "1993/04/24/", 
        "1993/04/25/", 
        "1993/04/26/", 
        "1993/04/27/", 
        "1993/04/28/", 
        "1993/04/29/", 
        "1993/04/30/"
    ]
}
