{
    "Keys": [
        {
            "ETag": "\"d41d8cd98f00b204e9800998ecf8427e\"", 
            "Key": "2003/08/", 
            "Size": 0
        }
    ], 
    "CommonPrefixes": [
        "2003/08/01/", 
        "2003/08/02/", 
        "2003/08/03/", 
        "2003/08/04/", 
        "2003/08/05/", 
        "2003/08/06/", 
        "2003/08/07/", 
        "2003/08/08/", 
        "2003/08/09/", 
        "2003/08/10/", 
        "2003/08/11/", 
        "2003/08/12/", 
        "2003/08/13/", 
        "2003/08/14/", 
        "2003/08/15/", 
        "2003/08/16/", 
        "2003/08/17/", 
        "2003/08/18/", 
        "2003/08/19/", 
        "2003/08/20/", 
        "2003/08/21/", 
        "2003/08/22/", 
        "2003/08/23/", 
        "2003/08/24/", 
        "2003/08/25/", 
        "2003/08/26/", 
        "2003/08/27/", 
        "2003/08/28/", 
        "2003/08/29/", 
        "2003/08/30/", 
        "2003/08/31/"
    ]
}
