{
    "Keys": [
        {
            "ETag": "\"d41d8cd98f00b204e9800998ecf8427e\"", 
            "Key": "1994/10/", 
            "Size": 0
        }
    ], 
    "CommonPrefixes": [
        "1994/10/01/", 
        "1994/10/02/", 
        "1994/10/03/", 
        "1994/10/04/", 
        "1994/10/05/", 
        "1994/10/06/", 
        "1994/10/07/", 
        "1994/10/08/", 
        "1994/10/09/", 
        "1994/10/10/", 
        "1994/10/11/", 
        "1994/10/12/", 
        "1994/10/13/", 
        "1994/10/14/", 
        "1994/10/15/", 
        "1994/10/16/", 
        "1994/10/17/", 
        "1994/10/18/", 
        "1994/10/19/", 
        "1994/10/20/", 
        "1994/10/21/", 
        "1994/10/22/", 
        "1994/10/23/", 
        "1994/10/24/", 
        "1994/10/25/", 
        "1994/10/26/", 
        "1994/10/27/", 
        "1994/10/28/", 
        "1994/10/29/", 
        "1994/10/30/", 
        "1994/10/31/"
    ]
}
