{
    "Keys": [
        {
            "ETag": "\"d41d8cd98f00b204e9800998ecf8427e\"", 
            "Key": "1999/10/", 
            "Size": 0
        }
    ], 
    "CommonPrefixes": [
        "1999/10/01/", 
        "1999/10/02/", 
        "1999/10/03/", 
        "1999/10/04/", 
        "1999/10/05/", 
        "1999/10/06/", 
        "1999/10/07/", 
        "1999/10/08/", 
        "1999/10/09/", 
        "1999/10/10/", 
        "1999/10/11/", 
        "1999/10/12/", 
        "1999/10/13/", 
        "1999/10/14/", 
        "1999/10/15/", 
        "1999/10/16/", 
        "1999/10/17/", 
        "1999/10/18/", 
        "1999/10/19/", 
        "1999/10/20/", 
        "1999/10/21/", 
        "1999/10/22/", 
        "1999/10/23/", 
        "1999/10/24/", 
        "1999/10/25/", 
        "1999/10/26/", 
        "1999/10/27/", 
        "1999/10/28/", 
        "1999/10/29/", 
        "1999/10/30/", 
        "1999/10/31/"
    ]
}
