{
    "Keys": [
        {
            "ETag": "\"d41d8cd98f00b204e9800998ecf8427e\"", 
            "Key": "2001/07/", 
            "Size": 0
        }
    ], 
    "CommonPrefixes": [
        "2001/07/01/", 
        "2001/07/02/", 
        "2001/07/03/", 
        "2001/07/04/", 
        "2001/07/05/", 
        "2001/07/06/", 
        "2001/07/07/", 
        "2001/07/08/", 
        "2001/07/09/", 
        "2001/07/10/", 
        "2001/07/11/", 
        "2001/07/12/", 
        "2001/07/13/", 
        "2001/07/14/", 
        "2001/07/15/", 
        "2001/07/16/", 
        "2001/07/17/", 
        "2001/07/18/", 
        "2001/07/19/", 
        "2001/07/20/", 
        "2001/07/21/", 
        "2001/07/22/", 
        "2001/07/23/", 
        "2001/07/24/", 
        "2001/07/25/", 
        "2001/07/26/", 
        "2001/07/27/", 
        "2001/07/28/", 
        "2001/07/29/", 
        "2001/07/30/", 
        "2001/07/31/"
    ]
}
