{
    "Keys": [
        {
            "ETag": "\"d41d8cd98f00b204e9800998ecf8427e\"", 
            "Key": "2006/04/", 
            "Size": 0
        }
    ], 
    "CommonPrefixes": [
        "2006/04/01/", 
        "2006/04/02/", 
        "2006/04/03/", 
        "2006/04/04/", 
        "2006/04/05/", 
        "2006/04/06/", 
        "2006/04/07/", 
        "2006/04/08/", 
        "2006/04/09/", 
        "2006/04/10/", 
        "2006/04/11/", 
        "2006/04/12/", 
        "2006/04/13/", 
        "2006/04/14/", 
        "2006/04/15/", 
        "2006/04/16/", 
        "2006/04/17/", 
        "2006/04/18/", 
        "2006/04/19/", 
        "2006/04/20/", 
        "2006/04/21/", 
        "2006/04/22/", 
        "2006/04/23/", 
        "2006/04/24/", 
        "2006/04/25/", 
        "2006/04/26/", 
        "2006/04/27/", 
        "2006/04/28/", 
        "2006/04/29/", 
        "2006/04/30/"
    ]
}
