{
    "Keys": null, 
    "CommonPrefixes": [
        "2014/07/01/", 
        "2014/07/02/", 
        "2014/07/03/", 
        "2014/07/04/", 
        "2014/07/05/", 
        "2014/07/06/", 
        "2014/07/07/", 
        "2014/07/08/", 
        "2014/07/09/", 
        "2014/07/10/", 
        "2014/07/11/", 
        "2014/07/12/", 
        "2014/07/13/", 
        "2014/07/14/", 
        "2014/07/15/", 
        "2014/07/16/", 
        "2014/07/17/", 
        "2014/07/18/", 
        "2014/07/19/", 
        "2014/07/20/", 
        "2014/07/21/", 
        "2014/07/22/", 
        "2014/07/23/", 
        "2014/07/24/", 
        "2014/07/25/", 
        "2014/07/26/", 
        "2014/07/27/", 
        "2014/07/28/", 
        "2014/07/29/", 
        "2014/07/30/", 
        "2014/07/31/"
    ]
}
