{
    "Keys": [
        {
            "ETag": "\"d41d8cd98f00b204e9800998ecf8427e\"", 
            "Key": "2004/02/", 
            "Size": 0
        }
    ], 
    "CommonPrefixes": [
        "2004/02/01/", 
        "2004/02/02/", 
        "2004/02/03/", 
        "2004/02/04/", 
        "2004/02/05/", 
        "2004/02/06/", 
        "2004/02/07/", 
        "2004/02/08/", 
        "2004/02/09/", 
        "2004/02/10/", 
        "2004/02/11/", 
        "2004/02/12/", 
        "2004/02/13/", 
        "2004/02/14/", 
        "2004/02/15/", 
        "2004/02/16/", 
        "2004/02/17/", 
        "2004/02/18/", 
        "2004/02/19/", 
        "2004/02/20/", 
        "2004/02/21/", 
        "2004/02/22/", 
        "2004/02/23/", 
        "2004/02/24/", 
        "2004/02/25/", 
        "2004/02/26/", 
        "2004/02/27/", 
        "2004/02/28/", 
        "2004/02/29/"
    ]
}
