{
    "Keys": [
        {
            "ETag": "\"d41d8cd98f00b204e9800998ecf8427e\"", 
            "Key": "2007/09/", 
            "Size": 0
        }
    ], 
    "CommonPrefixes": [
        "2007/09/01/", 
        "2007/09/02/", 
        "2007/09/03/", 
        "2007/09/04/", 
        "2007/09/05/", 
        "2007/09/06/", 
        "2007/09/07/", 
        "2007/09/08/", 
        "2007/09/09/", 
        "2007/09/10/", 
        "2007/09/11/", 
        "2007/09/12/", 
        "2007/09/13/", 
        "2007/09/14/", 
        "2007/09/15/", 
        "2007/09/16/", 
        "2007/09/17/", 
        "2007/09/18/", 
        "2007/09/19/", 
        "2007/09/20/", 
        "2007/09/21/", 
        "2007/09/22/", 
        "2007/09/23/", 
        "2007/09/24/", 
        "2007/09/25/", 
        "2007/09/26/", 
        "2007/09/27/", 
        "2007/09/28/", 
        "2007/09/29/", 
        "2007/09/30/"
    ]
}
