{
    "Keys": [
        {
            "ETag": "\"d41d8cd98f00b204e9800998ecf8427e\"", 
            "Key": "2001/11/", 
            "Size": 0
        }
    ], 
    "CommonPrefixes": [
        "2001/11/01/", 
        "2001/11/02/", 
        "2001/11/03/", 
        "2001/11/04/", 
        "2001/11/05/", 
        "2001/11/06/", 
        "2001/11/07/", 
        "2001/11/08/", 
        "2001/11/09/", 
        "2001/11/10/", 
        "2001/11/11/", 
        "2001/11/12/", 
        "2001/11/13/", 
        "2001/11/14/", 
        "2001/11/15/", 
        "2001/11/16/", 
        "2001/11/17/", 
        "2001/11/18/", 
        "2001/11/19/", 
        "2001/11/20/", 
        "2001/11/21/", 
        "2001/11/22/", 
        "2001/11/23/", 
        "2001/11/24/", 
        "2001/11/25/", 
        "2001/11/26/", 
        "2001/11/27/", 
        "2001/11/28/", 
        "2001/11/29/", 
        "2001/11/30/"
    ]
}
