{
    "Keys": [
        {
            "ETag": "\"d41d8cd98f00b204e9800998ecf8427e\"", 
            "Key": "1996/10/", 
            "Size": 0
        }
    ], 
    "CommonPrefixes": [
        "1996/10/01/", 
        "1996/10/02/", 
        "1996/10/03/", 
        "1996/10/04/", 
        "1996/10/05/", 
        "1996/10/06/", 
        "1996/10/07/", 
        "1996/10/08/", 
        "1996/10/09/", 
        "1996/10/10/", 
        "1996/10/11/", 
        "1996/10/12/", 
        "1996/10/13/", 
        "1996/10/14/", 
        "1996/10/15/", 
        "1996/10/16/", 
        "1996/10/17/", 
        "1996/10/18/", 
        "1996/10/19/", 
        "1996/10/20/", 
        "1996/10/21/", 
        "1996/10/22/", 
        "1996/10/23/", 
        "1996/10/24/", 
        "1996/10/25/", 
        "1996/10/26/", 
        "1996/10/27/", 
        "1996/10/28/", 
        "1996/10/29/", 
        "1996/10/30/", 
        "1996/10/31/"
    ]
}
