{
    "Keys": null, 
    "CommonPrefixes": [
        "2011/06/01/", 
        "2011/06/02/", 
        "2011/06/03/", 
        "2011/06/04/", 
        "2011/06/05/", 
        "2011/06/06/", 
        "2011/06/07/", 
        "2011/06/08/", 
        "2011/06/09/", 
        "2011/06/10/", 
        "2011/06/11/", 
        "2011/06/12/", 
        "2011/06/13/", 
        "2011/06/14/", 
        "2011/06/15/", 
        "2011/06/16/", 
        "2011/06/17/", 
        "2011/06/18/", 
        "2011/06/19/", 
        "2011/06/20/", 
        "2011/06/21/", 
        "2011/06/22/", 
        "2011/06/23/", 
        "2011/06/24/", 
        "2011/06/25/", 
        "2011/06/26/", 
        "2011/06/27/", 
        "2011/06/28/", 
        "2011/06/29/", 
        "2011/06/30/"
    ]
}
