{
    "Keys": null, 
    "CommonPrefixes": [
        "2014/06/01/", 
        "2014/06/02/", 
        "2014/06/03/", 
        "2014/06/04/", 
        "2014/06/05/", 
        "2014/06/06/", 
        "2014/06/07/", 
        "2014/06/08/", 
        "2014/06/09/", 
        "2014/06/10/", 
        "2014/06/11/", 
        "2014/06/12/", 
        "2014/06/13/", 
        "2014/06/14/", 
        "2014/06/15/", 
        "2014/06/16/", 
        "2014/06/17/", 
        "2014/06/18/", 
        "2014/06/19/", 
        "2014/06/20/", 
        "2014/06/21/", 
        "2014/06/22/", 
        "2014/06/23/", 
        "2014/06/24/", 
        "2014/06/25/", 
        "2014/06/26/", 
        "2014/06/27/", 
        "2014/06/28/", 
        "2014/06/29/", 
        "2014/06/30/"
    ]
}
