{
    "Keys": [
        {
            "ETag": "\"d41d8cd98f00b204e9800998ecf8427e\"", 
            "Key": "2004/01/", 
            "Size": 0
        }
    ], 
    "CommonPrefixes": [
        "2004/01/01/", 
        "2004/01/02/", 
        "2004/01/03/", 
        "2004/01/04/", 
        "2004/01/05/", 
        "2004/01/06/", 
        "2004/01/07/", 
        "2004/01/08/", 
        "2004/01/09/", 
        "2004/01/10/", 
        "2004/01/11/", 
        "2004/01/12/", 
        "2004/01/13/", 
        "2004/01/14/", 
        "2004/01/15/", 
        "2004/01/16/", 
        "2004/01/17/", 
        "2004/01/18/", 
        "2004/01/19/", 
        "2004/01/20/", 
        "2004/01/21/", 
        "2004/01/22/", 
        "2004/01/23/", 
        "2004/01/24/", 
        "2004/01/25/", 
        "2004/01/26/", 
        "2004/01/27/", 
        "2004/01/28/", 
        "2004/01/29/", 
        "2004/01/30/", 
        "2004/01/31/"
    ]
}
