{
    "Keys": [
        {
            "ETag": "\"d41d8cd98f00b204e9800998ecf8427e\"", 
            "Key": "2005/02/", 
            "Size": 0
        }
    ], 
    "CommonPrefixes": [
        "2005/02/01/", 
        "2005/02/02/", 
        "2005/02/03/", 
        "2005/02/04/", 
        "2005/02/05/", 
        "2005/02/06/", 
        "2005/02/07/", 
        "2005/02/08/", 
        "2005/02/09/", 
        "2005/02/10/", 
        "2005/02/11/", 
        "2005/02/12/", 
        "2005/02/13/", 
        "2005/02/14/", 
        "2005/02/15/", 
        "2005/02/16/", 
        "2005/02/17/", 
        "2005/02/18/", 
        "2005/02/19/", 
        "2005/02/20/", 
        "2005/02/21/", 
        "2005/02/22/", 
        "2005/02/23/", 
        "2005/02/24/", 
        "2005/02/25/", 
        "2005/02/26/", 
        "2005/02/27/", 
        "2005/02/28/"
    ]
}
