{
    "Keys": [
        {
            "ETag": "\"d41d8cd98f00b204e9800998ecf8427e\"", 
            "Key": "2006/06/", 
            "Size": 0
        }
    ], 
    "CommonPrefixes": [
        "2006/06/01/", 
        "2006/06/02/", 
        "2006/06/03/", 
        "2006/06/04/", 
        "2006/06/05/", 
        "2006/06/06/", 
        "2006/06/07/", 
        "2006/06/08/", 
        "2006/06/09/", 
        "2006/06/10/", 
        "2006/06/11/", 
        "2006/06/12/", 
        "2006/06/13/", 
        "2006/06/14/", 
        "2006/06/15/", 
        "2006/06/16/", 
        "2006/06/17/", 
        "2006/06/18/", 
        "2006/06/19/", 
        "2006/06/20/", 
        "2006/06/21/", 
        "2006/06/22/", 
        "2006/06/23/", 
        "2006/06/24/", 
        "2006/06/25/", 
        "2006/06/26/", 
        "2006/06/27/", 
        "2006/06/28/", 
        "2006/06/29/", 
        "2006/06/30/"
    ]
}
