{
    "Keys": [
        {
            "ETag": "\"d41d8cd98f00b204e9800998ecf8427e\"", 
            "Key": "1995/11/", 
            "Size": 0
        }
    ], 
    "CommonPrefixes": [
        "1995/11/01/", 
        "1995/11/02/", 
        "1995/11/03/", 
        "1995/11/04/", 
        "1995/11/05/", 
        "1995/11/06/", 
        "1995/11/07/", 
        "1995/11/08/", 
        "1995/11/09/", 
        "1995/11/10/", 
        "1995/11/11/", 
        "1995/11/12/", 
        "1995/11/13/", 
        "1995/11/14/", 
        "1995/11/15/", 
        "1995/11/16/", 
        "1995/11/17/", 
        "1995/11/18/", 
        "1995/11/19/", 
        "1995/11/20/", 
        "1995/11/21/", 
        "1995/11/22/", 
        "1995/11/23/", 
        "1995/11/24/", 
        "1995/11/25/", 
        "1995/11/26/", 
        "1995/11/27/", 
        "1995/11/28/", 
        "1995/11/29/", 
        "1995/11/30/"
    ]
}
