{
    "Keys": [
        {
            "ETag": "\"d41d8cd98f00b204e9800998ecf8427e\"", 
            "Key": "2008/04/", 
            "Size": 0
        }
    ], 
    "CommonPrefixes": [
        "2008/04/01/", 
        "2008/04/02/", 
        "2008/04/03/", 
        "2008/04/04/", 
        "2008/04/05/", 
        "2008/04/06/", 
        "2008/04/07/", 
        "2008/04/08/", 
        "2008/04/09/", 
        "2008/04/10/", 
        "2008/04/11/", 
        "2008/04/12/", 
        "2008/04/13/", 
        "2008/04/14/", 
        "2008/04/15/", 
        "2008/04/16/", 
        "2008/04/17/", 
        "2008/04/18/", 
        "2008/04/19/", 
        "2008/04/20/", 
        "2008/04/21/", 
        "2008/04/22/", 
        "2008/04/23/", 
        "2008/04/24/", 
        "2008/04/25/", 
        "2008/04/26/", 
        "2008/04/27/", 
        "2008/04/28/", 
        "2008/04/29/", 
        "2008/04/30/"
    ]
}
