{
    "Keys": [
        {
            "ETag": "\"d41d8cd98f00b204e9800998ecf8427e\"", 
            "Key": "2006/07/", 
            "Size": 0
        }
    ], 
    "CommonPrefixes": [
        "2006/07/01/", 
        "2006/07/02/", 
        "2006/07/03/", 
        "2006/07/04/", 
        "2006/07/05/", 
        "2006/07/06/", 
        "2006/07/07/", 
        "2006/07/08/", 
        "2006/07/09/", 
        "2006/07/10/", 
        "2006/07/11/", 
        "2006/07/12/", 
        "2006/07/13/", 
        "2006/07/14/", 
        "2006/07/15/", 
        "2006/07/16/", 
        "2006/07/17/", 
        "2006/07/18/", 
        "2006/07/19/", 
        "2006/07/20/", 
        "2006/07/21/", 
        "2006/07/22/", 
        "2006/07/23/", 
        "2006/07/24/", 
        "2006/07/25/", 
        "2006/07/26/", 
        "2006/07/27/", 
        "2006/07/28/", 
        "2006/07/29/", 
        "2006/07/30/", 
        "2006/07/31/"
    ]
}
