{
    "Keys": [
        {
            "ETag": "\"d41d8cd98f00b204e9800998ecf8427e\"", 
            "Key": "1996/11/", 
            "Size": 0
        }
    ], 
    "CommonPrefixes": [
        "1996/11/01/", 
        "1996/11/02/", 
        "1996/11/03/", 
        "1996/11/04/", 
        "1996/11/05/", 
        "1996/11/06/", 
        "1996/11/07/", 
        "1996/11/08/", 
        "1996/11/09/", 
        "1996/11/10/", 
        "1996/11/11/", 
        "1996/11/12/", 
        "1996/11/13/", 
        "1996/11/14/", 
        "1996/11/15/", 
        "1996/11/16/", 
        "1996/11/17/", 
        "1996/11/18/", 
        "1996/11/19/", 
        "1996/11/20/", 
        "1996/11/21/", 
        "1996/11/22/", 
        "1996/11/23/", 
        "1996/11/24/", 
        "1996/11/25/", 
        "1996/11/26/", 
        "1996/11/27/", 
        "1996/11/28/", 
        "1996/11/29/", 
        "1996/11/30/"
    ]
}
