{
    "Keys": [
        {
            "ETag": "\"d41d8cd98f00b204e9800998ecf8427e\"", 
            "Key": "2000/10/", 
            "Size": 0
        }
    ], 
    "CommonPrefixes": [
        "2000/10/01/", 
        "2000/10/02/", 
        "2000/10/03/", 
        "2000/10/04/", 
        "2000/10/05/", 
        "2000/10/06/", 
        "2000/10/07/", 
        "2000/10/08/", 
        "2000/10/09/", 
        "2000/10/10/", 
        "2000/10/11/", 
        "2000/10/12/", 
        "2000/10/13/", 
        "2000/10/14/", 
        "2000/10/15/", 
        "2000/10/16/", 
        "2000/10/17/", 
        "2000/10/18/", 
        "2000/10/19/", 
        "2000/10/20/", 
        "2000/10/21/", 
        "2000/10/22/", 
        "2000/10/23/", 
        "2000/10/24/", 
        "2000/10/25/", 
        "2000/10/26/", 
        "2000/10/27/", 
        "2000/10/28/", 
        "2000/10/29/", 
        "2000/10/30/", 
        "2000/10/31/"
    ]
}
