{
    "Keys": [
        {
            "ETag": "\"d41d8cd98f00b204e9800998ecf8427e\"", 
            "Key": "2013/05/", 
            "Size": 0
        }
    ], 
    "CommonPrefixes": [
        "2013/05/01/", 
        "2013/05/02/", 
        "2013/05/03/", 
        "2013/05/04/", 
        "2013/05/05/", 
        "2013/05/06/", 
        "2013/05/07/", 
        "2013/05/08/", 
        "2013/05/09/", 
        "2013/05/10/", 
        "2013/05/11/", 
        "2013/05/12/", 
        "2013/05/13/", 
        "2013/05/14/", 
        "2013/05/15/", 
        "2013/05/16/", 
        "2013/05/17/", 
        "2013/05/18/", 
        "2013/05/19/", 
        "2013/05/20/", 
        "2013/05/21/", 
        "2013/05/22/", 
        "2013/05/23/", 
        "2013/05/24/", 
        "2013/05/25/", 
        "2013/05/26/", 
        "2013/05/27/", 
        "2013/05/28/", 
        "2013/05/29/", 
        "2013/05/30/", 
        "2013/05/31/"
    ]
}
