{
    "Keys": [
        {
            "ETag": "\"d41d8cd98f00b204e9800998ecf8427e\"", 
            "Key": "2004/05/", 
            "Size": 0
        }
    ], 
    "CommonPrefixes": [
        "2004/05/01/", 
        "2004/05/02/", 
        "2004/05/03/", 
        "2004/05/04/", 
        "2004/05/05/", 
        "2004/05/06/", 
        "2004/05/07/", 
        "2004/05/08/", 
        "2004/05/09/", 
        "2004/05/10/", 
        "2004/05/11/", 
        "2004/05/12/", 
        "2004/05/13/", 
        "2004/05/14/", 
        "2004/05/15/", 
        "2004/05/16/", 
        "2004/05/17/", 
        "2004/05/18/", 
        "2004/05/19/", 
        "2004/05/20/", 
        "2004/05/21/", 
        "2004/05/22/", 
        "2004/05/23/", 
        "2004/05/24/", 
        "2004/05/25/", 
        "2004/05/26/", 
        "2004/05/27/", 
        "2004/05/28/", 
        "2004/05/29/", 
        "2004/05/30/", 
        "2004/05/31/"
    ]
}
