{
    "Keys": [
        {
            "ETag": "\"d41d8cd98f00b204e9800998ecf8427e\"", 
            "Key": "1997/04/", 
            "Size": 0
        }
    ], 
    "CommonPrefixes": [
        "1997/04/01/", 
        "1997/04/02/", 
        "1997/04/03/", 
        "1997/04/04/", 
        "1997/04/05/", 
        "1997/04/06/", 
        "1997/04/07/", 
        "1997/04/08/", 
        "1997/04/09/", 
        "1997/04/10/", 
        "1997/04/11/", 
        "1997/04/12/", 
        "1997/04/13/", 
        "1997/04/14/", 
        "1997/04/15/", 
        "1997/04/16/", 
        "1997/04/17/", 
        "1997/04/18/", 
        "1997/04/19/", 
        "1997/04/20/", 
        "1997/04/21/", 
        "1997/04/22/", 
        "1997/04/23/", 
        "1997/04/24/", 
        "1997/04/25/", 
        "1997/04/26/", 
        "1997/04/27/", 
        "1997/04/28/", 
        "1997/04/29/", 
        "1997/04/30/"
    ]
}
