{
    "Keys": [
        {
            "ETag": "\"d41d8cd98f00b204e9800998ecf8427e\"", 
            "Key": "1993/02/", 
            "Size": 0
        }
    ], 
    "CommonPrefixes": [
        "1993/02/01/", 
        "1993/02/02/", 
        "1993/02/03/", 
        "1993/02/04/", 
        "1993/02/05/", 
        "1993/02/06/", 
        "1993/02/07/", 
        "1993/02/08/", 
        "1993/02/09/", 
        "1993/02/10/", 
        "1993/02/11/", 
        "1993/02/12/", 
        "1993/02/13/", 
        "1993/02/14/", 
        "1993/02/15/", 
        "1993/02/16/", 
        "1993/02/17/", 
        "1993/02/18/", 
        "1993/02/19/", 
        "1993/02/20/", 
        "1993/02/21/", 
        "1993/02/22/", 
        "1993/02/23/", 
        "1993/02/24/", 
        "1993/02/25/", 
        "1993/02/26/", 
        "1993/02/27/", 
        "1993/02/28/"
    ]
}
